,Years,Country,Number of Attacks,Number of Deaths,GDP,PR,CL,Total Rating,Status
0,1972,Algeria,1,1583,6766766611.0,6,6,12,NF
1,1972,Argentina,20,28781,34733000536.0,6,3,9,PF
2,1972,Australia,8,12421,52051401869.0,1,1,2,F
3,1972,Austria,7,9972,22059612477.0,1,1,2,F
4,1972,Belgium,4,6044,37209418019.0,1,1,2,F
5,1972,Brazil,3,4297,58434858375.0,5,5,10,PF
6,1972,Brunei,5,7590,270818555.8,6,5,11,NF
7,1972,Cambodia,2,3012,505549441.4,6,5,11,NF
8,1972,Canada,4,5420,113000000000.0,1,1,2,F
9,1972,Colombia,2,3030,8671358733.0,2,2,4,F
10,1972,Egypt,1,1180,9299638056.0,6,6,12,NF
11,1972,El Salvador,2,3237,1263720000.0,2,3,5,F
12,1972,France,11,16114,203000000000.0,1,2,3,F
13,1972,Greece,2,3111,16885511364.0,6,6,12,NF
14,1972,India,1,1185,71463193830.0,2,3,5,F
15,1972,Iran,15,19603,17153463263.0,5,6,11,NF
16,1972,Ireland,5,7349,6318060582.0,1,2,3,F
18,1972,Italy,4,5761,145000000000.0,1,2,3,F
19,1972,Jordan,7,11026,788574629.0,6,6,12,NF
20,1972,Kuwait,1,1123,4451200973.0,4,4,8,PF
22,1972,Mexico,1,1616,45200000000.0,5,3,8,PF
23,1972,Netherlands,1,1169,54706557264.0,1,1,2,F
24,1972,Panama,1,1121,1673411700.0,7,6,13,NF
25,1972,Philippines,7,9135,9067872579.0,4,6,10,PF
26,1972,Portugal,1,1566,11239117865.0,5,6,11,NF
27,1972,Spain,19,24682,59132415221.0,5,6,11,NF
28,1972,Sweden,3,3954,48954145809.0,1,1,2,F
30,1972,Thailand,1,1683,8177884553.0,7,5,12,NF
31,1972,Turkey,9,11491,20431095406.0,3,4,7,PF
32,1972,United Kingdom,292,411956,170000000000.0,1,1,2,F
33,1972,United States,68,90995,1280000000000.0,1,1,2,F
34,1972,Uruguay,7,10775,2189418001.0,3,4,7,PF
35,1973,Afghanistan,1,1862,1733333264.0,7,6,13,NF
36,1973,Argentina,60,116419,52544000117.0,2,2,4,F
37,1973,Austria,2,3740,29515467707.0,1,1,2,F
38,1973,Belgium,1,1805,47743801490.0,1,1,2,F
39,1973,Brazil,2,3929,83592275863.0,5,5,10,PF
40,1973,Chile,7,14001,16836261173.0,7,5,12,NF
41,1973,Colombia,6,11115,10315760000.0,2,2,4,F
43,1973,Dominican Republic,3,5605,2344800000.0,3,2,5,F
44,1973,Ecuador,1,1978,3891755552.0,7,4,11,PF
45,1973,El Salvador,1,1855,1442320000.0,2,3,5,F
47,1973,France,14,26855,264000000000.0,1,2,3,F
48,1973,Greece,11,20398,22347848101.0,7,5,12,NF
49,1973,Haiti,1,1718,466800000.0,6,6,12,NF
50,1973,Honduras,1,1965,912499950.0,6,3,9,PF
51,1973,Iran,4,7075,27081698250.0,5,6,11,NF
52,1973,Ireland,3,5479,7481173066.0,1,2,3,F
54,1973,Italy,15,29638,175000000000.0,1,2,3,F
55,1973,Japan,2,3852,432000000000.0,2,1,3,F
56,1973,Jordan,1,1752,943700547.8,6,6,12,NF
58,1973,Malaysia,1,2068,7662996767.0,2,3,5,F
59,1973,Mexico,6,12325,55280000000.0,4,3,7,PF
60,1973,Morocco,2,3649,6242177798.0,5,5,10,PF
61,1973,Myanmar,1,1840,2216399558.0,7,5,12,NF
62,1973,Netherlands,1,1957,71840909664.0,1,1,2,F
63,1973,New Zealand,1,1981,12802281898.0,1,1,2,F
64,1973,Peru,3,5859,10994381895.0,7,5,12,NF
65,1973,Portugal,1,2027,15090564186.0,5,6,11,NF
66,1973,Spain,21,40142,78639525985.0,5,6,11,NF
67,1973,Sudan,1,1771,3571666667.0,6,6,12,NF
69,1973,United Kingdom,189,361629,193000000000.0,1,1,2,F
70,1973,United States,58,112241,1430000000000.0,1,1,2,F
71,1973,Zambia,1,2019,2268714286.0,5,5,10,PF
72,1974,Andorra,1,2469,186558696.3,4,4,8,PF
73,1974,Argentina,71,172222,72436777342.0,2,4,6,PF
74,1974,Australia,1,2730,88981577008.0,1,1,2,F
75,1974,Austria,1,2341,35189299912.0,1,1,2,F
76,1974,Belgium,5,12028,56033077879.0,1,1,2,F
77,1974,Bolivia,1,2165,2100249875.0,6,5,11,NF
78,1974,Botswana,1,2211,306033848.4,2,3,5,F
79,1974,Canada,1,2203,160000000000.0,1,1,2,F
80,1974,Chad,1,2345,652532796.1,6,7,13,NF
81,1974,Dominican Republic,2,5129,2925700000.0,4,2,6,PF
82,1974,Ecuador,3,7902,6599259421.0,7,4,11,PF
83,1974,El Salvador,3,6831,1665880000.0,2,3,5,F
85,1974,France,29,70509,286000000000.0,1,2,3,F
86,1974,Greece,6,14313,25351306818.0,2,2,4,F
87,1974,Guatemala,1,2307,3161499900.0,4,3,7,PF
88,1974,Haiti,2,4778,565400000.0,6,6,12,NF
89,1974,Iran,11,26863,46209092072.0,5,6,11,NF
90,1974,Ireland,3,7035,7896860615.0,1,2,3,F
92,1974,Italy,22,54428,200000000000.0,1,2,3,F
93,1974,Jamaica,2,4806,2375096249.0,1,2,3,F
94,1974,Japan,3,7800,480000000000.0,2,1,3,F
95,1974,Kuwait,1,2226,13004774557.0,4,3,7,PF
97,1974,Mexico,16,37387,72000000000.0,4,3,7,PF
98,1974,Netherlands,2,4999,87243413395.0,1,1,2,F
99,1974,Nicaragua,1,2732,1520900045.0,5,4,9,PF
100,1974,Pakistan,2,4920,8899191919.0,3,5,8,PF
101,1974,Peru,3,7929,13858441211.0,6,6,12,NF
102,1974,Philippines,1,2330,15607825070.0,5,5,10,PF
103,1974,Singapore,1,2208,5221534956.0,5,5,10,PF
104,1974,South Africa,1,2736,36807721038.0,4,5,9,PF
105,1974,South Korea,1,2513,19544094741.0,5,6,11,PF
106,1974,Spain,14,35054,97274006346.0,5,5,10,PF
108,1974,Syria,4,10233,4244670160.0,6,7,13,NF
109,1974,Thailand,1,2349,13703000530.0,5,3,8,PF
110,1974,Turkey,1,2622,35599913836.0,2,3,5,F
112,1974,United Kingdom,203,497680,206000000000.0,1,1,2,F
113,1974,United States,94,233391,1550000000000.0,1,1,2,F
114,1975,Argentina,38,116285,52438647922.0,2,4,6,PF
115,1975,Austria,2,6810,40059206763.0,1,1,2,F
116,1975,Colombia,10,30254,13098633902.0,2,3,5,F
117,1975,Cyprus,2,5702,489914760.7,4,4,8,PF
118,1975,El Salvador,3,9521,1884120100.0,2,3,5,F
120,1975,France,39,119442,361000000000.0,1,2,3,F
121,1975,Greece,4,13513,28525876727.0,2,2,4,F
122,1975,Guatemala,5,16535,3645900000.0,4,3,7,PF
123,1975,India,1,2763,98472796457.0,2,5,7,PF
124,1975,Iran,13,39207,51776222350.0,6,6,12,NF
125,1975,Iraq,1,2853,13458516763.0,7,7,14,NF
126,1975,Ireland,7,22714,9483808362.0,1,2,3,F
128,1975,Italy,7,21005,228000000000.0,1,2,3,F
129,1975,Japan,12,37554,522000000000.0,2,1,3,F
130,1975,Kenya,4,11654,3259344936.0,5,5,10,PF
131,1975,Kuwait,1,2949,12024138276.0,4,3,7,PF
133,1975,Malaysia,3,9582,9298800799.0,3,4,7,PF
134,1975,Mexico,10,31907,88000000000.0,4,3,7,PF
136,1975,Netherlands,4,12887,100000000000.0,1,1,2,F
137,1975,Nicaragua,1,3165,1590428523.0,5,4,9,PF
138,1975,Pakistan,2,5537,11230606061.0,5,5,10,PF
139,1975,Peru,2,6016,16877163792.0,6,4,10,PF
140,1975,Philippines,4,12819,16875240683.0,5,5,10,PF
141,1975,Portugal,4,12986,19347607843.0,5,3,8,PF
142,1975,Somalia,1,2894,710850226.5,7,6,13,NF
143,1975,Spain,136,417952,115000000000.0,5,5,10,PF
144,1975,Sri Lanka,1,3140,3791298146.0,2,4,6,PF
145,1975,Sweden,1,2962,82885397621.0,2,1,3,F
147,1975,Syria,2,5501,5566756757.0,6,7,13,NF
149,1975,Turkey,10,32248,44633707243.0,2,3,5,F
150,1975,United Kingdom,194,610509,242000000000.0,1,1,2,F
151,1975,United States,149,464453,1680000000000.0,1,1,2,F
152,1975,Zambia,1,2883,2618666667.0,5,5,10,PF
153,1976,Algeria,1,3490,17728347375.0,6,6,12,NF
154,1976,Argentina,54,213176,51169499891.0,6,5,11,NF
155,1976,Austria,4,16986,42959976222.0,1,1,2,F
156,1976,Bahamas,1,3587,642100000.0,1,2,3,F
157,1976,Barbados,2,8175,435911268.6,1,1,2,F
158,1976,Belgium,1,3846,71113882968.0,1,1,2,F
159,1976,Bolivia,1,3970,2731984008.0,6,4,10,PF
160,1976,Brazil,5,20681,153000000000.0,4,5,9,PF
161,1976,Chile,2,7788,10341925249.0,7,5,12,NF
162,1976,Colombia,22,84626,15341403660.0,2,3,5,F
163,1976,Costa Rica,12,48014,2412555426.0,1,1,2,F
164,1976,Ecuador,2,8348,9091924305.0,6,4,10,PF
165,1976,El Salvador,13,51214,2328280100.0,3,3,6,PF
167,1976,France,58,227161,372000000000.0,1,1,2,F
168,1976,Greece,21,84245,31152835821.0,2,2,4,F
169,1976,Guatemala,13,51928,4365300200.0,4,3,7,PF
170,1976,India,1,3856,103000000000.0,3,5,8,PF
171,1976,Iran,4,15011,68055295081.0,6,6,12,NF
172,1976,Iraq,3,13177,17754825601.0,7,7,14,NF
173,1976,Ireland,5,19129,9453756015.0,1,1,2,F
175,1976,Italy,173,696072,225000000000.0,2,1,3,F
176,1976,Jamaica,1,3975,2966010230.0,1,3,4,F
177,1976,Japan,1,3632,586000000000.0,2,1,3,F
178,1976,Jordan,1,4320,1708734940.0,6,6,12,NF
179,1976,Kenya,2,7655,3474542392.0,5,5,10,PF
180,1976,Kuwait,1,3962,13131668947.0,6,5,11,NF
182,1976,Mexico,20,81082,89025974026.0,4,4,8,PF
183,1976,Morocco,1,3488,9584323309.0,5,5,10,PF
184,1976,Myanmar,2,8671,3812349977.0,6,6,12,NF
186,1976,Netherlands,3,12870,109000000000.0,1,1,2,F
187,1976,Nigeria,1,3593,36308883249.0,6,4,10,PF
188,1976,Pakistan,3,12572,13168080808.0,4,5,9,PF
189,1976,Panama,2,8167,2588106000.0,7,6,13,NF
190,1976,Paraguay,1,3899,1698960317.0,5,6,11,NF
191,1976,Philippines,10,38473,19380945793.0,5,5,10,PF
192,1976,Portugal,15,59795,20332831565.0,2,2,4,F
193,1976,South Africa,1,4345,36603349970.0,4,5,9,PF
194,1976,Spain,50,197728,119000000000.0,5,3,8,PF
196,1976,Syria,2,8518,6417632803.0,6,6,12,NF
197,1976,Trinidad and Tobago,1,4112,2500410584.0,2,2,4,F
198,1976,Turkey,35,133765,51280134554.0,2,3,5,F
199,1976,United Kingdom,194,759550,233000000000.0,1,1,2,F
200,1976,United States,105,406207,1870000000000.0,1,1,2,F
202,1977,Argentina,17,87659,56781000101.0,6,6,12,NF
203,1977,Austria,5,22957,51545758888.0,1,1,2,F
204,1977,Bangladesh,1,4438,9651149302.0,6,4,10,PF
205,1977,Belgium,1,5711,82839905459.0,1,1,2,F
206,1977,Bolivia,1,5185,3227436282.0,6,4,10,PF
207,1977,Brazil,1,4936,176000000000.0,4,5,9,PF
208,1977,Chile,6,31091,13962893422.0,7,5,12,NF
209,1977,Colombia,80,422413,19470960619.0,2,3,5,F
210,1977,Costa Rica,5,23993,3072427013.0,1,1,2,F
211,1977,Cyprus,1,5646,734887974.0,3,4,7,PF
213,1977,Ecuador,7,34830,11026346590.0,6,4,10,PF
214,1977,Egypt,1,5602,14400806876.0,5,4,9,PF
215,1977,El Salvador,6,29180,2941640100.0,4,4,8,PF
217,1977,France,53,271114,410000000000.0,1,2,3,F
218,1977,Greece,47,234143,36176234968.0,2,2,4,F
219,1977,Guatemala,8,42298,5480500200.0,3,4,7,PF
220,1977,India,1,5326,121000000000.0,2,2,4,F
221,1977,Indonesia,1,5570,45808915663.0,5,5,10,PF
222,1977,Iran,5,24818,80600122702.0,6,5,11,NF
223,1977,Ireland,3,16180,11248340431.0,1,1,2,F
225,1977,Italy,308,1590334,258000000000.0,2,2,4,F
226,1977,Japan,4,18720,721000000000.0,2,1,3,F
228,1977,Malaysia,2,11136,13139397879.0,3,4,7,PF
229,1977,Malta,1,5576,625573345.5,2,2,4,F
230,1977,Mauritania,4,19644,799029666.6,6,6,12,NF
231,1977,Mexico,19,96604,81814159292.0,4,3,7,PF
232,1977,Netherlands,6,30134,127000000000.0,1,1,2,F
233,1977,Nicaragua,5,26736,2239857061.0,5,5,10,PF
234,1977,Peru,4,19441,14620386674.0,6,4,10,PF
235,1977,Philippines,2,10406,22283185056.0,5,5,10,PF
236,1977,Portugal,15,76969,21439523311.0,2,2,4,F
237,1977,Saudi Arabia,1,4771,74188363506.0,6,6,12,NF
238,1977,South Africa,15,79515,40651349967.0,5,6,11,PF
239,1977,Spain,147,751696,132000000000.0,2,3,5,F
241,1977,Syria,3,14890,6882292994.0,5,6,11,PF
242,1977,Thailand,3,15071,19779315170.0,6,5,11,NF
243,1977,Turkey,189,931291,58676813687.0,2,3,5,F
244,1977,United Arab Emirates,1,5484,24871775165.0,5,5,10,PF
245,1977,United Kingdom,140,695946,263000000000.0,1,1,2,F
246,1977,United States,130,648987,2080000000000.0,1,1,2,F
247,1977,Zambia,1,4542,2483000000.0,5,5,10,PF
248,1978,Algeria,1,6172,26364491313.0,6,6,12,NF
250,1978,Argentina,25,162014,58082870156.0,6,5,11,NF
251,1978,Australia,2,12309,119000000000.0,1,1,2,F
252,1978,Austria,1,6547,62052259073.0,1,1,2,F
253,1978,Belgium,8,47052,101000000000.0,1,1,2,F
254,1978,Bolivia,3,19174,3758220890.0,5,3,8,PF
255,1978,Brazil,5,31849,200000000000.0,4,4,8,PF
257,1978,Chile,8,54389,15989933708.0,6,5,11,NF
258,1978,Colombia,158,1014374,23263511958.0,2,3,5,F
259,1978,Costa Rica,2,13284,3523208810.0,1,1,2,F
260,1978,Cyprus,2,12668,964026512.2,3,4,7,PF
261,1978,Denmark,1,5830,60362931854.0,1,1,2,F
262,1978,Dominican Republic,1,6150,4734400000.0,2,2,4,F
263,1978,Ecuador,11,71697,11922502171.0,5,4,9,PF
264,1978,Egypt,2,13606,14811704063.0,5,5,10,PF
265,1978,El Salvador,91,605423,3127960000.0,5,5,10,PF
267,1978,France,59,381643,507000000000.0,1,2,3,F
268,1978,Greece,39,275627,44270204082.0,2,2,4,F
269,1978,Guatemala,29,194145,6070600200.0,3,4,7,PF
270,1978,Guyana,1,7015,507080000.0,4,4,8,PF
271,1978,Indonesia,2,13229,51455719100.0,5,5,10,PF
272,1978,Iran,27,186554,77994316621.0,5,5,10,PF
273,1978,Ireland,3,19138,14647996074.0,1,1,2,F
275,1978,Italy,277,1735244,315000000000.0,2,2,4,F
276,1978,Japan,35,223176,1010000000000.0,2,1,3,F
277,1978,Kenya,1,6350,5303734883.0,5,4,9,PF
278,1978,Kuwait,1,6445,15500908760.0,6,4,10,PF
280,1978,Mexico,30,189034,103000000000.0,4,4,8,PF
281,1978,Morocco,1,7101,13236854105.0,3,4,7,PF
284,1978,Netherlands,3,18693,156000000000.0,1,1,2,F
285,1978,Nicaragua,76,507505,2142128604.0,5,5,10,PF
286,1978,Pakistan,2,13173,17811515152.0,6,5,11,PF
287,1978,Peru,4,27257,12495779622.0,5,4,9,PF
288,1978,Philippines,36,236846,25762077665.0,5,5,10,PF
289,1978,Portugal,4,25058,23487614051.0,2,2,4,F
290,1978,South Africa,9,57096,46739449962.0,5,6,11,PF
291,1978,Spain,209,1329702,161000000000.0,2,2,4,F
292,1978,Sweden,1,5831,104000000000.0,1,1,2,F
294,1978,Syria,1,6819,8251974522.0,5,6,11,PF
295,1978,Thailand,5,33923,24006570178.0,5,4,9,PF
296,1978,Turkey,52,339665,65147022486.0,2,3,5,F
297,1978,United Arab Emirates,1,6400,23775831783.0,5,5,10,PF
298,1978,United Kingdom,100,663834,336000000000.0,1,1,2,F
299,1978,United States,87,563207,2350000000000.0,1,1,2,F
300,1978,Zambia,3,20908,2813375000.0,5,5,10,PF
301,1979,Afghanistan,3,25998,3697940410.0,7,7,14,NF
302,1979,Algeria,1,7460,33243422158.0,6,6,12,NF
304,1979,Argentina,16,143985,69252328953.0,6,5,11,NF
305,1979,Australia,2,15274,135000000000.0,1,1,2,F
306,1979,Austria,5,42126,73937296963.0,1,1,2,F
308,1979,Bangladesh,1,7971,15565480322.0,3,3,6,PF
309,1979,Belgium,8,68293,116000000000.0,1,1,2,F
310,1979,Bolivia,14,133358,4421343606.0,3,3,6,PF
311,1979,Brazil,6,54888,221000000000.0,4,3,7,PF
312,1979,Chile,49,415731,21803696985.0,6,5,11,PF
313,1979,Colombia,140,1210416,27940411250.0,2,3,5,F
314,1979,Costa Rica,2,16660,4035519323.0,1,1,2,F
315,1979,Cyprus,5,41819,1288715210.0,3,3,6,PF
316,1979,Denmark,3,24112,70366241969.0,1,1,2,F
318,1979,Dominican Republic,2,15638,5498800000.0,2,3,5,F
319,1979,Ecuador,2,17545,14175166008.0,2,2,4,F
320,1979,Egypt,1,8110,18020571429.0,5,5,10,PF
321,1979,El Salvador,326,2938390,3463639900.0,5,4,9,PF
323,1979,France,212,1787852,614000000000.0,1,2,3,F
324,1979,Gabon,1,8747,3030251116.0,6,6,12,NF
325,1979,Greece,9,79077,54481876725.0,2,2,4,F
326,1979,Guatemala,60,535436,6902600200.0,4,5,9,PF
327,1979,Guyana,2,18442,530440000.0,4,4,8,PF
328,1979,Honduras,6,52419,3544281976.0,6,3,9,PF
329,1979,India,20,179059,153000000000.0,2,2,4,F
330,1979,Iran,82,726198,90391877326.0,5,5,10,PF
331,1979,Iraq,2,18374,37816457839.0,7,7,14,NF
332,1979,Ireland,8,69638,18319334300.0,1,1,2,F
334,1979,Italy,209,1751128,394000000000.0,2,2,4,F
335,1979,Jamaica,2,14637,2425033998.0,2,3,5,F
336,1979,Japan,16,132238,1060000000000.0,2,1,3,F
338,1979,Lesotho,2,16673,290142517.8,5,5,10,PF
340,1979,Malaysia,1,8942,21213672089.0,3,4,7,PF
341,1979,Mexico,10,88130,135000000000.0,3,4,7,PF
342,1979,Morocco,2,15199,15912133569.0,4,4,8,PF
344,1979,Myanmar,19,142492,5093478602.0,7,6,13,NF
346,1979,Netherlands,3,27250,180000000000.0,1,1,2,F
347,1979,Nicaragua,206,1655138,1527852636.0,5,5,10,PF
348,1979,Norway,1,7734,53132244624.0,1,1,2,F
349,1979,Pakistan,7,62223,19688383838.0,6,5,11,NF
350,1979,Panama,4,32132,3704551600.0,5,5,10,PF
351,1979,Peru,3,22023,15962459447.0,5,4,9,PF
352,1979,Philippines,50,412375,31218507870.0,5,5,10,PF
354,1979,Portugal,15,131550,26622819672.0,2,2,4,F
355,1979,Saudi Arabia,1,9685,112000000000.0,6,6,12,NF
356,1979,South Africa,16,137818,57645721018.0,5,6,11,PF
357,1979,Spain,279,2386372,215000000000.0,2,2,4,F
358,1979,Sri Lanka,3,23290,3364611432.0,2,3,5,F
359,1979,Sweden,1,9878,123000000000.0,1,1,2,F
361,1979,Syria,28,253033,9929681529.0,5,6,11,PF
363,1979,Thailand,16,135785,27371699083.0,4,4,8,PF
364,1979,Trinidad and Tobago,1,9492,4602416625.0,2,2,4,F
365,1979,Tunisia,1,7332,7188191882.0,6,5,11,PF
366,1979,Turkey,141,1183090,89394085658.0,2,3,5,F
367,1979,Uganda,8,69519,2139025000.0,6,6,12,NF
368,1979,United Arab Emirates,2,19041,31225463218.0,5,5,10,PF
369,1979,United Kingdom,239,2069485,439000000000.0,1,1,2,F
370,1979,United States,69,612601,2630000000000.0,1,1,2,F
371,1979,Zambia,1,8413,3325500000.0,5,5,10,PF
372,1980,Argentina,6,67642,76961923742.0,6,5,11,NF
373,1980,Australia,6,74638,150000000000.0,1,1,2,F
374,1980,Austria,2,21547,82058912997.0,1,1,2,F
375,1980,Bahrain,1,12408,3072698328.0,5,5,10,PF
376,1980,Bangladesh,1,11014,18138049096.0,3,4,7,PF
377,1980,Belgium,8,91149,127000000000.0,1,1,2,F
379,1980,Bolivia,35,386958,4526916803.0,7,5,12,NF
380,1980,Brazil,19,215609,237000000000.0,4,3,7,PF
381,1980,Canada,3,33051,274000000000.0,1,1,2,F
382,1980,Chile,41,476995,29036709872.0,6,5,11,PF
383,1980,Colombia,141,1586205,33400735644.0,2,3,5,F
384,1980,Costa Rica,3,32384,4831447001.0,1,1,2,F
385,1980,Cyprus,1,10570,2154311277.0,3,3,6,PF
386,1980,Denmark,1,12326,71127528700.0,1,1,2,F
387,1980,Dominican Republic,1,10091,6761300000.0,2,3,5,F
388,1980,Ecuador,2,24175,17881514683.0,2,2,4,F
389,1980,Egypt,5,54474,21669908177.0,5,5,10,PF
390,1980,El Salvador,710,8070899,3573959900.0,5,5,10,PF
391,1980,France,94,1033079,701000000000.0,1,2,3,F
392,1980,Greece,15,173654,56829664269.0,1,2,3,F
393,1980,Grenada,4,47190,110900457.0,6,5,11,NF
394,1980,Guatemala,281,3189283,7878700000.0,6,6,12,NF
396,1980,Guyana,1,11198,603200000.0,5,4,9,PF
397,1980,Honduras,16,185427,3968160046.0,4,3,7,PF
398,1980,India,10,111231,186000000000.0,2,3,5,F
399,1980,Iran,67,718346,94362275580.0,5,5,10,PF
400,1980,Iraq,6,66025,52569000000.0,6,7,13,NF
401,1980,Ireland,6,67124,21747855640.0,1,1,2,F
403,1980,Italy,110,1195002,477000000000.0,1,2,3,F
404,1980,Jamaica,6,70058,2679409453.0,2,3,5,F
405,1980,Jordan,1,11781,3910036925.0,6,6,12,NF
406,1980,Kenya,1,12571,7265315332.0,5,4,9,PF
407,1980,Kuwait,4,44155,28638550499.0,6,4,10,PF
410,1980,Mexico,5,52071,205000000000.0,3,4,7,PF
411,1980,Myanmar,1,10118,5671769759.0,7,6,13,NF
413,1980,Netherlands,1,11113,195000000000.0,1,1,2,F
414,1980,Nicaragua,35,402723,2189347368.0,5,5,10,PF
415,1980,Nigeria,1,10025,64201788123.0,2,3,5,F
416,1980,Pakistan,1,10918,23654444444.0,7,5,12,NF
417,1980,Panama,4,42629,4614086400.0,4,4,8,PF
418,1980,Paraguay,2,22241,4448087302.0,5,5,10,PF
419,1980,Peru,64,770711,18134029180.0,2,3,5,F
420,1980,Philippines,60,682432,36848242784.0,5,5,10,PF
421,1980,Portugal,8,93642,32896519824.0,2,2,4,F
422,1980,Senegal,1,10519,4510107330.0,4,4,8,PF
423,1980,Somalia,1,10568,603592656.8,7,7,14,NF
424,1980,South Africa,23,254720,82980483388.0,5,6,11,PF
425,1980,Spain,187,2107631,233000000000.0,2,3,5,F
426,1980,Switzerland,7,82274,123000000000.0,1,1,2,F
427,1980,Syria,33,362008,13062420382.0,5,7,12,NF
428,1980,Thailand,26,284530,32353440727.0,3,4,7,PF
429,1980,Tunisia,1,10105,8744134354.0,6,5,11,PF
430,1980,Turkey,95,1034805,68789289566.0,5,5,10,PF
431,1980,United Arab Emirates,1,11527,43598748449.0,5,5,10,PF
432,1980,United Kingdom,134,1473806,565000000000.0,1,1,2,F
433,1980,United States,67,750012,2860000000000.0,1,1,2,F
434,1980,Zimbabwe,14,165367,6678868200.0,3,4,7,PF
436,1981,Angola,1,14888,5553824464.0,7,7,14,NF
437,1981,Argentina,2,28393,78676842366.0,6,5,11,NF
438,1981,Australia,1,14801,177000000000.0,1,1,2,F
439,1981,Austria,3,41753,71034228443.0,1,1,2,F
440,1981,Bahamas,1,13194,1426500000.0,1,2,3,F
441,1981,Bangladesh,1,13631,20249694002.0,5,5,10,PF
442,1981,Belgium,6,84562,105000000000.0,1,1,2,F
443,1981,Bolivia,5,70828,5872756933.0,7,4,11,PF
444,1981,Brazil,11,150792,258000000000.0,4,3,7,PF
445,1981,Central African Republic,1,13871,694803502.7,7,5,12,NF
446,1981,Chile,34,466958,34509878044.0,6,5,11,PF
447,1981,Colombia,172,2395060,36388366869.0,2,3,5,F
448,1981,Costa Rica,10,135241,2623807074.0,1,1,2,F
449,1981,Cyprus,3,40632,2087496374.0,1,2,3,F
450,1981,Denmark,6,82591,61877813965.0,1,1,2,F
451,1981,Ecuador,2,27929,21810767209.0,2,2,4,F
452,1981,Egypt,9,124654,22136081081.0,5,5,10,PF
453,1981,El Salvador,664,9224875,3437200200.0,4,5,9,PF
454,1981,France,66,904110,616000000000.0,1,2,3,F
455,1981,Greece,20,274296,52346506765.0,1,2,3,F
456,1981,Guatemala,399,5603585,8607500300.0,6,6,12,NF
457,1981,Guyana,1,13719,570357107.1,5,4,9,PF
458,1981,Honduras,17,234500,4043894879.0,2,3,5,F
459,1981,India,16,219775,193000000000.0,2,3,5,F
460,1981,Indonesia,1,13177,85518233451.0,5,5,10,PF
461,1981,Iran,108,1522833,100000000000.0,6,6,12,NF
462,1981,Iraq,3,39774,37823000000.0,6,7,13,NF
463,1981,Ireland,5,65719,20670190138.0,1,1,2,F
465,1981,Italy,69,954553,431000000000.0,1,2,3,F
466,1981,Jamaica,1,12718,2979061412.0,2,3,5,F
467,1981,Japan,1,13106,1220000000000.0,1,1,2,F
468,1981,Jordan,2,26953,4384685230.0,6,6,12,NF
469,1981,Kuwait,3,38882,25056672166.0,4,4,8,PF
471,1981,Lesotho,5,71848,434188034.2,5,5,10,PF
472,1981,Mexico,3,40749,264000000000.0,3,4,7,PF
474,1981,Netherlands,1,13226,164000000000.0,1,1,2,F
475,1981,New Zealand,2,28219,24417617184.0,1,1,2,F
476,1981,Nicaragua,47,666350,2448290110.0,6,5,11,PF
477,1981,Norway,1,14096,63596654761.0,1,1,2,F
478,1981,Pakistan,4,54347,28100606061.0,7,5,12,NF
479,1981,Panama,4,55940,5222421500.0,5,5,10,PF
480,1981,Peru,149,2070593,21649137620.0,2,3,5,F
481,1981,Philippines,31,417001,40499645208.0,5,4,9,PF
483,1981,Portugal,10,139047,31977276873.0,2,2,4,F
484,1981,Seychelles,2,29737,154902869.0,6,6,12,NF
485,1981,Somalia,8,101004,699112266.8,7,7,14,NF
486,1981,South Africa,42,585780,85454420500.0,5,6,11,NF
487,1981,Spain,107,1449808,203000000000.0,2,3,5,F
488,1981,Sri Lanka,2,29544,4415844156.0,2,3,5,F
489,1981,Sudan,1,13780,10016500000.0,5,5,10,PF
490,1981,Switzerland,13,181442,112000000000.0,1,1,2,F
491,1981,Syria,41,531731,16758471338.0,5,7,12,NF
492,1981,Thailand,18,251601,34846107862.0,3,4,7,PF
493,1981,Trinidad and Tobago,1,14731,6992083333.0,1,2,3,F
494,1981,Turkey,8,108238,71040020140.0,5,5,10,PF
495,1981,Uganda,25,329314,1337300000.0,5,5,10,PF
496,1981,United Arab Emirates,3,39332,49333424135.0,5,5,10,PF
497,1981,United Kingdom,142,1976106,541000000000.0,1,1,2,F
498,1981,United States,74,1028095,3210000000000.0,1,1,2,F
499,1981,Zambia,1,14438,3872666667.0,5,6,11,PF
500,1981,Zimbabwe,9,118797,8011373800.0,3,5,8,PF
501,1982,Angola,2,35030,5553824464.0,7,7,14,NF
502,1982,Argentina,9,145377,84307486837.0,3,3,6,PF
503,1982,Australia,2,35301,194000000000.0,1,1,2,F
504,1982,Austria,11,182069,71275287570.0,1,1,2,F
505,1982,Bangladesh,1,15735,18525399202.0,6,5,11,PF
506,1982,Belgium,1,17041,92095926188.0,1,1,2,F
507,1982,Bolivia,27,440822,5587490265.0,2,3,5,F
508,1982,Brazil,4,64999,271000000000.0,3,3,6,PF
509,1982,Bulgaria,2,33996,19342000000.0,7,7,14,NF
510,1982,Canada,5,80469,314000000000.0,1,1,2,F
511,1982,Chile,21,346705,25325893206.0,6,5,11,PF
512,1982,Colombia,222,3627745,38968039722.0,2,3,5,F
513,1982,Costa Rica,6,98987,2606621255.0,1,1,2,F
514,1982,Cyprus,1,17532,2159242417.0,1,2,3,F
515,1982,Dominican Republic,2,32488,8267400000.0,1,2,3,F
516,1982,Ecuador,3,51480,19929853575.0,2,2,4,F
517,1982,Egypt,1,17076,27655172414.0,5,5,10,PF
518,1982,El Salvador,537,8877840,3399189100.0,4,5,9,PF
519,1982,France,62,1008879,585000000000.0,1,2,3,F
520,1982,Greece,19,309807,54617989796.0,1,2,3,F
521,1982,Guatemala,354,5670103,8716999700.0,6,6,12,NF
522,1982,Honduras,34,566227,4266503526.0,3,3,6,PF
523,1982,India,13,218182,201000000000.0,2,3,5,F
524,1982,Iran,26,418449,126000000000.0,6,6,12,NF
525,1982,Iraq,5,81829,42382333333.0,6,7,13,NF
526,1982,Ireland,4,64163,21474752962.0,1,1,2,F
528,1982,Italy,23,377868,427000000000.0,1,2,3,F
529,1982,Japan,2,34025,1130000000000.0,1,1,2,F
530,1982,Jordan,1,15247,4680567376.0,6,6,12,NF
531,1982,Kuwait,1,16884,21577977770.0,4,4,8,PF
533,1982,Lesotho,2,32991,348746822.6,5,5,10,PF
534,1982,Mexico,3,48441,185000000000.0,3,4,7,PF
536,1982,Myanmar,2,32608,5926911888.0,7,7,14,NF
538,1982,Netherlands,2,34010,158000000000.0,1,1,2,F
539,1982,Nicaragua,63,1050145,2465165180.0,6,5,11,PF
540,1982,Pakistan,4,67504,30725971564.0,7,5,12,NF
541,1982,Peru,350,5837832,21793496819.0,2,3,5,F
542,1982,Philippines,38,626200,42206011275.0,5,5,10,PF
543,1982,Portugal,3,50054,30527754793.0,1,2,3,F
544,1982,Qatar,1,16527,7596703214.0,5,5,10,PF
545,1982,South Africa,26,436348,78423059790.0,5,6,11,PF
546,1982,South Korea,1,15732,78358866335.0,5,6,11,PF
547,1982,Spain,146,2443241,196000000000.0,1,2,3,F
548,1982,Sri Lanka,2,33751,4768765017.0,3,4,7,PF
549,1982,Sudan,3,49043,9240000000.0,5,5,10,PF
550,1982,Suriname,1,17365,915000000.0,7,6,13,NF
551,1982,Switzerland,6,97222,115000000000.0,1,1,2,F
552,1982,Syria,20,316593,17525605096.0,6,7,13,NF
554,1982,Thailand,3,49844,36589797857.0,3,4,7,PF
555,1982,Turkey,5,80254,64546332581.0,4,5,9,PF
556,1982,Uganda,1,15586,2177500000.0,4,5,9,PF
557,1982,United Kingdom,95,1577901,515000000000.0,1,1,2,F
558,1982,United States,78,1285186,3340000000000.0,1,1,2,F
559,1982,Zimbabwe,12,201452,8539700700.0,4,5,9,PF
560,1983,Angola,7,131566,5787823809.0,7,7,14,NF
561,1983,Argentina,18,340829,104000000000.0,2,2,4,F
562,1983,Belgium,8,151889,87184239053.0,1,1,2,F
563,1983,Bolivia,27,540279,5422440962.0,2,3,5,F
564,1983,Brazil,8,158393,190000000000.0,3,3,6,PF
565,1983,Canada,1,18241,341000000000.0,1,1,2,F
566,1983,Chile,106,2100410,20355959237.0,6,5,11,PF
567,1983,Colombia,234,4472966,38729822782.0,2,3,5,F
568,1983,Costa Rica,3,60215,3146770104.0,1,1,2,F
569,1983,Cyprus,2,36795,2160364071.0,1,2,3,F
570,1983,Ecuador,10,188114,17152483214.0,2,2,4,F
571,1983,El Salvador,371,7024583,3506347800.0,3,5,8,PF
572,1983,Ethiopia,3,57642,8567890821.0,7,7,14,NF
573,1983,France,121,2294366,560000000000.0,1,2,3,F
574,1983,Greece,11,211320,49428873839.0,1,2,3,F
575,1983,Grenada,1,18604,131803552.2,5,3,8,PF
576,1983,Guatemala,117,2257584,9050000400.0,5,6,11,PF
577,1983,Haiti,6,107745,1623600000.0,7,6,13,NF
578,1983,Honduras,29,565760,4476697185.0,2,3,5,F
579,1983,Iceland,1,18549,2765950295.0,1,1,2,F
580,1983,India,47,903184,218000000000.0,2,3,5,F
581,1983,Iran,10,195746,156000000000.0,5,6,11,PF
582,1983,Iraq,3,54923,40712903226.0,7,7,14,NF
583,1983,Ireland,4,80386,20766047764.0,1,1,2,F
585,1983,Italy,7,133275,443000000000.0,1,1,2,F
586,1983,Japan,12,234021,1240000000000.0,1,1,2,F
587,1983,Jordan,7,137932,4920407601.0,5,5,10,PF
588,1983,Kuwait,7,143157,20869434305.0,4,4,8,PF
590,1983,Lesotho,12,222540,386699308.9,5,5,10,PF
591,1983,Luxembourg,2,36383,4524217751.0,1,1,2,F
592,1983,Malaysia,1,17841,30346788438.0,3,5,8,PF
593,1983,Mexico,2,39036,156000000000.0,3,4,7,PF
595,1983,Myanmar,4,78133,6105882120.0,7,7,14,NF
597,1983,Netherlands,2,35780,153000000000.0,1,1,2,F
598,1983,Nicaragua,299,5759223,2743341724.0,5,5,10,PF
599,1983,Nigeria,3,60928,97094911791.0,7,5,12,NF
600,1983,Pakistan,9,169251,28691889764.0,7,5,12,NF
601,1983,Panama,9,173907,5923755900.0,4,3,7,PF
602,1983,Peru,536,10247852,17345624454.0,2,3,5,F
603,1983,Philippines,16,302316,37759237658.0,4,4,8,PF
604,1983,Portugal,9,180322,27239650742.0,1,2,3,F
605,1983,Somalia,1,18620,733901365.9,7,7,14,NF
606,1983,South Africa,56,1097421,87415851376.0,5,6,11,PF
607,1983,South Korea,1,19818,87760360941.0,5,5,10,PF
608,1983,Spain,122,2357189,171000000000.0,1,2,3,F
609,1983,Sri Lanka,7,133570,5167913302.0,3,4,7,PF
610,1983,Sudan,3,59477,8230153846.0,6,6,12,NF
611,1983,Suriname,1,18042,883500000.0,7,6,13,NF
612,1983,Sweden,1,18152,105000000000.0,1,1,2,F
613,1983,Switzerland,3,56116,115000000000.0,1,1,2,F
614,1983,Syria,1,19204,18672866242.0,6,7,13,NF
615,1983,Thailand,1,19731,40042826244.0,3,4,7,PF
616,1983,Trinidad and Tobago,1,19510,7763750000.0,1,2,3,F
617,1983,Turkey,5,99187,61678280115.0,3,5,8,PF
618,1983,Uganda,6,107684,2240333333.0,4,5,9,PF
619,1983,United Arab Emirates,1,19836,42803323345.0,5,5,10,PF
620,1983,United Kingdom,177,3387557,490000000000.0,1,1,2,F
621,1983,United States,44,841803,3630000000000.0,1,1,2,F
622,1983,Zimbabwe,6,109868,7764067000.0,4,5,9,PF
623,1984,Angola,11,251608,6135166254.0,7,7,14,NF
624,1984,Argentina,46,1043975,79092001998.0,2,2,4,F
625,1984,Austria,4,93562,67985344887.0,1,1,2,F
626,1984,Bangladesh,1,23379,18920840000.0,5,5,10,PF
627,1984,Belgium,10,233248,83349530159.0,1,1,2,F
628,1984,Bolivia,14,319752,6169501038.0,2,3,5,F
629,1984,Brazil,5,111159,188000000000.0,3,2,5,F
630,1984,Bulgaria,1,23100,17594944444.0,7,7,14,NF
631,1984,Burkina Faso,1,22433,1459880019.0,7,6,13,NF
632,1984,Chad,1,21262,919103735.3,7,7,14,NF
633,1984,Chile,563,12647408,19622527480.0,6,5,11,PF
634,1984,Colombia,237,5208449,38253120738.0,2,3,5,F
635,1984,Costa Rica,2,46121,3660476459.0,1,1,2,F
636,1984,Cyprus,7,159512,2278248953.0,1,2,3,F
637,1984,Ecuador,24,527597,16912515183.0,2,3,5,F
638,1984,El Salvador,273,6108011,3661683400.0,2,4,6,PF
639,1984,Ethiopia,1,23528,8096302367.0,7,7,14,NF
640,1984,France,145,3279308,531000000000.0,1,2,3,F
641,1984,Greece,28,636152,48020024184.0,2,2,4,F
642,1984,Guatemala,74,1625103,9470000100.0,4,4,8,PF
643,1984,Honduras,12,262378,4915311846.0,2,3,5,F
644,1984,India,159,3482493,212000000000.0,2,3,5,F
645,1984,Indonesia,2,45480,84853699994.0,5,6,11,PF
646,1984,Iran,17,387103,162000000000.0,5,6,11,PF
647,1984,Iraq,2,43734,46938387097.0,7,7,14,NF
648,1984,Ireland,1,23480,20106648455.0,1,1,2,F
650,1984,Italy,14,312192,438000000000.0,1,1,2,F
651,1984,Japan,15,340284,1320000000000.0,1,1,2,F
652,1984,Jordan,5,116174,4966710013.0,5,5,10,PF
653,1984,Kuwait,1,23897,21697297872.0,4,4,8,PF
655,1984,Lesotho,1,21752,333158476.2,5,5,10,PF
657,1984,Malta,7,165782,1101828569.0,2,4,6,PF
658,1984,Mexico,4,89314,184000000000.0,4,4,8,PF
661,1984,Netherlands,1,23237,144000000000.0,1,1,2,F
662,1984,New Zealand,1,21477,21665975319.0,1,1,2,F
663,1984,Nicaragua,302,6737156,3105517091.0,5,5,10,PF
664,1984,Pakistan,3,66449,31151825467.0,4,5,9,PF
665,1984,Panama,2,45075,6183387100.0,6,3,9,PF
666,1984,Paraguay,2,47294,4502462807.0,5,5,10,PF
667,1984,Peru,592,13332733,17599660054.0,2,3,5,F
668,1984,Philippines,43,971786,35730202751.0,4,3,7,PF
669,1984,Portugal,14,324740,25217969050.0,1,2,3,F
671,1984,Saudi Arabia,2,47351,120000000000.0,6,7,13,NF
672,1984,Somalia,2,46500,788307213.4,7,7,14,NF
673,1984,South Africa,60,1344821,77344092907.0,5,6,11,PF
674,1984,Spain,143,3207726,172000000000.0,1,2,3,F
675,1984,Sri Lanka,81,1845570,6043474843.0,3,4,7,PF
676,1984,Sudan,5,107734,9701357143.0,6,6,12,NF
677,1984,Suriname,1,20769,864000000.0,6,6,12,NF
678,1984,Switzerland,1,22805,110000000000.0,1,1,2,F
679,1984,Syria,1,20989,19195414013.0,6,7,13,NF
680,1984,Thailand,1,21271,41797592963.0,3,4,7,PF
681,1984,Turkey,19,440925,59989909458.0,3,5,8,PF
682,1984,Uganda,3,63979,3615647477.0,5,4,9,PF
683,1984,United Kingdom,145,3144938,461000000000.0,1,1,2,F
684,1984,United States,63,1422424,4040000000000.0,1,1,2,F
685,1984,Uruguay,4,87368,4850241442.0,2,2,4,F
686,1984,Zimbabwe,3,71297,6352125900.0,4,6,10,PF
687,1985,Angola,6,154399,7558613008.0,7,7,14,NF
688,1985,Argentina,43,1110484,88416668900.0,2,1,3,F
689,1985,Austria,4,104601,69386774408.0,1,1,2,F
690,1985,Bangladesh,1,25893,22278423077.0,4,5,9,PF
691,1985,Belgium,21,545862,86268264148.0,1,1,2,F
692,1985,Bolivia,13,324844,5377277407.0,2,3,5,F
693,1985,Botswana,1,25074,1114764007.0,2,3,5,F
694,1985,Brazil,1,26378,211000000000.0,2,2,4,F
695,1985,Canada,3,74630,365000000000.0,1,1,2,F
696,1985,Chad,1,24363,1033069710.0,7,7,14,NF
697,1985,Chile,232,5995782,17702885394.0,6,5,11,PF
698,1985,Colombia,382,9755025,34894411352.0,2,3,5,F
699,1985,Costa Rica,5,125537,3919203960.0,1,1,2,F
700,1985,Cyprus,7,179128,2430411900.0,1,2,3,F
701,1985,Denmark,4,103976,62658568287.0,1,1,2,F
702,1985,Ecuador,12,302166,17149094590.0,2,3,5,F
703,1985,Egypt,2,52450,39053502251.0,5,4,9,PF
704,1985,El Salvador,436,11035974,3800368600.0,3,4,7,PF
705,1985,Ethiopia,1,24498,9480840483.0,7,7,14,NF
706,1985,France,106,2669942,553000000000.0,1,2,3,F
707,1985,Greece,35,899176,47820851221.0,2,2,4,F
708,1985,Guatemala,63,1603106,9721652087.0,3,3,6,PF
709,1985,Honduras,9,230710,5278120713.0,2,3,5,F
710,1985,India,39,995143,233000000000.0,2,3,5,F
711,1985,Indonesia,2,48822,85289491750.0,5,6,11,PF
712,1985,Iran,3,73961,180000000000.0,5,6,11,PF
713,1985,Ireland,2,50701,21270013326.0,1,1,2,F
715,1985,Italy,11,280693,452000000000.0,1,1,2,F
716,1985,Japan,10,252192,1400000000000.0,1,1,2,F
717,1985,Kuwait,2,51387,21442619681.0,6,5,11,PF
719,1985,Luxembourg,10,259727,4577211767.0,1,1,2,F
720,1985,Malta,1,26859,1117835286.0,2,4,6,PF
721,1985,Mexico,1,25618,195000000000.0,4,4,8,PF
722,1985,Morocco,2,51341,14991283216.0,4,5,9,PF
725,1985,Nepal,9,229530,2619913956.0,3,4,7,PF
726,1985,Netherlands,4,102049,144000000000.0,1,1,2,F
727,1985,Nicaragua,258,6626102,2683816289.0,5,6,11,PF
728,1985,Niger,1,25271,1440581534.0,7,6,13,NF
729,1985,Pakistan,2,51445,31144920844.0,4,5,9,PF
730,1985,Paraguay,1,25551,3282449236.0,5,6,11,PF
731,1985,Peru,352,8955144,16548827018.0,2,3,5,F
732,1985,Philippines,124,3196670,34961565263.0,4,2,6,PF
733,1985,Portugal,20,494224,27115807742.0,1,2,3,F
735,1985,Saudi Arabia,2,49789,104000000000.0,6,7,13,NF
736,1985,Singapore,1,24597,19156532746.0,4,5,9,PF
737,1985,South Africa,106,2761738,59082638804.0,5,6,11,PF
738,1985,Spain,114,2897797,181000000000.0,1,2,3,F
739,1985,Sri Lanka,110,2824011,5978460972.0,3,4,7,PF
740,1985,Switzerland,7,175561,111000000000.0,1,1,2,F
741,1985,Syria,1,25846,21203821656.0,6,7,13,NF
742,1985,Thailand,1,25938,38900692712.0,3,3,6,PF
743,1985,Togo,3,80589,762359722.7,6,6,12,NF
744,1985,Turkey,2,51914,67234948265.0,3,4,7,PF
745,1985,Uganda,7,177905,3519666339.0,5,4,9,PF
746,1985,United Arab Emirates,2,49325,40603650232.0,5,5,10,PF
747,1985,United Kingdom,67,1708479,489000000000.0,1,1,2,F
748,1985,United States,40,1037699,4340000000000.0,1,1,2,F
749,1985,Uruguay,2,50217,4732017873.0,2,2,4,F
750,1985,Zambia,1,25589,2281258065.0,5,5,10,PF
751,1985,Zimbabwe,1,24468,5637259300.0,4,6,10,PF
752,1986,Angola,5,140525,7076793823.0,7,7,14,NF
753,1986,Argentina,33,938890,111000000000.0,2,1,3,F
754,1986,Australia,2,57296,182000000000.0,1,1,2,F
755,1986,Austria,4,112182,99036164939.0,1,1,2,F
756,1986,Bangladesh,11,315449,21774033333.0,4,5,9,PF
757,1986,Belgium,3,87785,120000000000.0,1,1,2,F
758,1986,Bolivia,4,112445,3958338883.0,2,3,5,F
759,1986,Brazil,3,88455,256000000000.0,2,2,4,F
760,1986,Canada,2,57078,377000000000.0,1,1,2,F
761,1986,Central African Republic,1,27711,1122265026.0,6,6,12,NF
762,1986,Chad,1,27055,1067828247.0,6,7,13,NF
763,1986,Chile,243,6888620,18891048819.0,6,5,11,PF
764,1986,Colombia,307,8771584,34942489684.0,2,3,5,F
765,1986,Costa Rica,1,27883,4418983871.0,1,1,2,F
766,1986,Cyprus,3,87498,3090734463.0,1,2,3,F
767,1986,Denmark,2,59142,88078760104.0,1,1,2,F
768,1986,Ecuador,8,229688,15314143988.0,2,3,5,F
769,1986,Egypt,4,113170,41253507951.0,5,4,9,PF
770,1986,El Salvador,175,4923593,3771663200.0,3,4,7,PF
771,1986,Ethiopia,1,29820,9848600870.0,6,7,13,NF
772,1986,Finland,1,28376,73531550551.0,1,2,3,F
773,1986,France,95,2744578,771000000000.0,1,2,3,F
774,1986,Greece,41,1169373,56379593476.0,2,2,4,F
775,1986,Guatemala,31,879212,7231963516.0,3,3,6,PF
776,1986,Honduras,8,232284,5677828959.0,2,3,5,F
777,1986,Iceland,1,29538,3989622715.0,1,1,2,F
778,1986,India,96,2746903,249000000000.0,2,3,5,F
779,1986,Indonesia,4,112452,79954072570.0,5,6,11,PF
780,1986,Iran,6,172244,209000000000.0,5,6,11,PF
781,1986,Ireland,2,58440,28714571852.0,1,1,2,F
783,1986,Italy,7,197245,640000000000.0,1,1,2,F
784,1986,Jamaica,1,29595,2754566176.0,2,2,4,F
785,1986,Japan,10,280925,2080000000000.0,1,1,2,F
786,1986,Kuwait,1,28388,17903681693.0,6,5,11,PF
788,1986,Luxembourg,1,27611,6685595088.0,1,1,2,F
789,1986,Malaysia,15,412926,27734562640.0,3,5,8,PF
790,1986,Malta,1,29654,1435079200.0,1,2,3,F
791,1986,Mexico,2,56056,135000000000.0,4,4,8,PF
792,1986,Morocco,2,57427,19462175322.0,4,5,9,PF
795,1986,Netherlands,14,400880,201000000000.0,1,1,2,F
796,1986,Nicaragua,171,4840760,2885710609.0,5,5,10,PF
797,1986,Pakistan,24,679641,31899070056.0,4,5,9,PF
798,1986,Panama,5,138684,6797834200.0,5,5,10,PF
799,1986,Peru,568,16033441,15244232958.0,2,3,5,F
800,1986,Philippines,80,2276708,33987178952.0,2,2,4,F
801,1986,Portugal,11,311983,38745901354.0,1,2,3,F
802,1986,Saudi Arabia,1,29810,86962013011.0,6,7,13,NF
803,1986,South Africa,159,4498813,67521602553.0,5,6,11,PF
804,1986,South Korea,2,58843,117000000000.0,4,4,8,PF
805,1986,Spain,125,3575474,251000000000.0,1,2,3,F
806,1986,Sri Lanka,142,4032696,6405210564.0,3,4,7,PF
807,1986,Sudan,6,171900,15769062500.0,4,5,9,PF
808,1986,Suriname,8,234171,891000000.0,4,4,8,PF
809,1986,Sweden,3,69926,150000000000.0,1,1,2,F
810,1986,Syria,4,114184,25460636943.0,6,7,13,NF
811,1986,Thailand,3,84500,43096746122.0,3,3,6,PF
812,1986,Tunisia,2,56949,9018136020.0,6,5,11,PF
813,1986,Turkey,7,204503,75728009963.0,2,4,6,PF
814,1986,Uganda,1,27431,3923232122.0,5,4,9,PF
815,1986,United Arab Emirates,1,27100,33943612095.0,5,5,10,PF
816,1986,United Kingdom,95,2717966,601000000000.0,1,1,2,F
817,1986,United States,49,1409066,4580000000000.0,1,1,2,F
818,1986,Uruguay,2,56743,5880112788.0,2,2,4,F
819,1986,Zambia,1,28102,1661948718.0,5,5,10,PF
820,1986,Zimbabwe,1,27147,6217523700.0,5,6,11,PF
821,1987,Angola,3,96035,8089279285.0,7,7,14,NF
822,1987,Argentina,80,2525312,111000000000.0,2,1,3,F
823,1987,Austria,4,123912,124000000000.0,1,1,2,F
824,1987,Bangladesh,6,189864,24298032258.0,4,5,9,PF
825,1987,Belgium,1,32353,149000000000.0,1,1,2,F
826,1987,Bolivia,14,439445,4323623622.0,2,3,5,F
827,1987,Botswana,1,30640,1965274882.0,2,3,5,F
828,1987,Brazil,1,32241,283000000000.0,2,3,5,F
829,1987,Chile,173,5530919,22255407685.0,5,4,9,PF
830,1987,Colombia,337,10553420,36373307085.0,2,3,5,F
831,1987,Costa Rica,3,91616,4532952047.0,1,1,2,F
832,1987,Cyprus,10,303727,3704813886.0,1,2,3,F
833,1987,Denmark,2,63966,109000000000.0,1,1,2,F
834,1987,Djibouti,1,30487,373371738.3,6,6,12,NF
835,1987,Dominican Republic,15,477570,5826987099.0,1,3,4,F
836,1987,Ecuador,6,187684,13945431882.0,2,2,4,F
837,1987,Egypt,7,220005,40455616654.0,5,4,9,PF
838,1987,El Salvador,234,7393641,3958045800.0,3,3,6,PF
839,1987,Ethiopia,1,32718,10527338647.0,6,7,13,NF
840,1987,Fiji,3,95003,1177908192.0,5,4,9,PF
841,1987,France,87,2695035,934000000000.0,1,2,3,F
842,1987,Ghana,1,31512,5074829932.0,6,6,12,NF
843,1987,Greece,26,815089,65652750377.0,2,2,4,F
844,1987,Guatemala,56,1781960,7084399840.0,3,3,6,PF
845,1987,Haiti,10,327174,2047200000.0,7,5,12,NF
846,1987,Honduras,20,620256,6190521241.0,2,3,5,F
847,1987,India,166,5235673,279000000000.0,2,3,5,F
848,1987,Iran,1,31228,134000000000.0,5,6,11,NF
849,1987,Iraq,3,95653,56774193548.0,7,7,14,NF
850,1987,Ireland,24,729934,33920518493.0,1,1,2,F
852,1987,Italy,14,437337,806000000000.0,1,1,2,F
853,1987,Japan,10,311109,2530000000000.0,1,1,2,F
854,1987,Kuwait,12,371324,22365734482.0,6,5,11,PF
856,1987,Malta,4,125106,1751247763.0,1,2,3,F
857,1987,Mexico,1,32013,148000000000.0,3,4,7,PF
858,1987,Morocco,4,120798,21765261042.0,4,5,9,PF
860,1987,Myanmar,1,32511,9346762512.0,7,6,13,NF
862,1987,Netherlands,1,30953,245000000000.0,1,1,2,F
863,1987,Nicaragua,223,7106451,3851213728.0,5,4,9,PF
864,1987,Norway,2,64657,94230055659.0,1,1,2,F
865,1987,Pakistan,60,1896652,33351529275.0,3,3,6,PF
866,1987,Panama,4,128137,6827665300.0,6,5,11,NF
867,1987,Paraguay,1,31985,3971044724.0,6,6,12,NF
868,1987,Peru,627,19575427,20702298397.0,2,3,5,F
869,1987,Philippines,160,5023826,37791442731.0,2,3,5,F
870,1987,Singapore,2,65325,20919215578.0,4,5,9,PF
871,1987,Somalia,1,30029,1009792724.0,7,7,14,NF
872,1987,South Africa,133,4147299,88573697223.0,5,6,11,PF
873,1987,Spain,104,3247764,319000000000.0,1,2,3,F
874,1987,Sri Lanka,115,3645880,6682167120.0,3,4,7,PF
875,1987,Sudan,1,30416,20155555556.0,4,5,9,PF
876,1987,Suriname,13,401443,980000000.0,3,2,5,F
877,1987,Switzerland,1,31667,199000000000.0,1,1,2,F
878,1987,Tunisia,4,126966,9696271268.0,6,4,10,PF
879,1987,Turkey,43,1358366,87172789528.0,2,4,6,PF
880,1987,Uganda,1,32297,6269511615.0,5,5,10,PF
881,1987,United Kingdom,117,3653161,745000000000.0,1,1,2,F
882,1987,United States,34,1067849,4860000000000.0,1,1,2,F
883,1987,Zambia,1,32843,2269894737.0,6,5,11,PF
884,1987,Zimbabwe,11,347987,6741215100.0,6,5,11,PF
887,1989,Angola,12,464755,10207922517.0,7,7,14,NF
888,1989,Argentina,32,1236174,76636898036.0,1,2,3,F
889,1989,Australia,2,77372,300000000000.0,1,1,2,F
890,1989,Austria,2,77185,133000000000.0,1,1,2,F
891,1989,Bangladesh,36,1408133,28781714764.0,4,4,8,PF
892,1989,Belgium,7,272723,164000000000.0,1,1,2,F
893,1989,Bolivia,40,1543295,4715978868.0,2,3,5,F
894,1989,Botswana,2,77632,3083800685.0,1,2,3,F
895,1989,Brazil,5,193366,347000000000.0,2,2,4,F
897,1989,Canada,1,40832,565000000000.0,1,1,2,F
898,1989,Chile,146,5713236,29885685143.0,4,3,7,PF
899,1989,China,3,117694,348000000000.0,7,7,14,NF
900,1989,Colombia,492,19244545,39540080200.0,3,4,7,PF
901,1989,Costa Rica,1,37106,5251025767.0,1,1,2,F
902,1989,Cyprus,6,238360,4563482604.0,1,1,2,F
903,1989,Denmark,1,39591,112000000000.0,1,1,2,F
904,1989,Dominican Republic,11,419522,6686593060.0,1,3,4,F
905,1989,Ecuador,14,548426,13890828708.0,2,2,4,F
906,1989,Egypt,7,270180,39756299050.0,5,4,9,PF
907,1989,El Salvador,356,13632361,4372215300.0,3,4,7,PF
908,1989,Ethiopia,1,37482,11476584879.0,7,7,14,NF
909,1989,Fiji,2,80435,1182686577.0,6,4,10,PF
910,1989,France,25,986457,1030000000000.0,1,2,3,F
911,1989,Greece,50,1940351,79169043223.0,1,2,3,F
912,1989,Guatemala,79,3112429,8410724361.0,3,3,6,PF
913,1989,Haiti,3,115422,2736243800.0,7,5,12,NF
914,1989,Honduras,29,1111755,5432344902.0,2,3,5,F
916,1989,India,324,12579247,296000000000.0,2,3,5,F
917,1989,Indonesia,2,76627,94451427898.0,5,5,10,PF
918,1989,Iran,6,234386,120000000000.0,6,5,11,NF
919,1989,Iraq,4,157183,65831935484.0,7,6,13,NF
920,1989,Ireland,3,112961,39238392678.0,1,1,2,F
922,1989,Italy,15,578543,929000000000.0,1,1,2,F
923,1989,Japan,13,502976,3050000000000.0,1,1,2,F
924,1989,Kenya,4,154949,8283114648.0,6,6,12,NF
925,1989,Lebanon,141,5458461,2717998688.0,6,5,11,NF
926,1989,Malaysia,2,75763,38848567631.0,5,4,9,PF
927,1989,Mauritius,1,37477,2181930255.0,2,2,4,F
928,1989,Mexico,1,40912,221000000000.0,4,3,7,PF
930,1989,Myanmar,24,910996,15149052982.0,7,7,14,NF
931,1989,Namibia,11,433341,2535113565.0,4,3,7,PF
932,1989,Netherlands,5,202423,258000000000.0,1,1,2,F
933,1989,Nicaragua,21,817980,1013184746.0,5,5,10,PF
934,1989,Niger,1,39778,2179567108.0,7,6,13,NF
935,1989,Pakistan,45,1764795,40171018229.0,3,3,6,PF
936,1989,Panama,2,74055,5918469800.0,7,6,13,NF
937,1989,Papua New Guinea,24,940174,3546460177.0,2,2,4,F
938,1989,Peru,630,24474556,22499559086.0,2,4,6,PF
939,1989,Philippines,156,6130611,48513735777.0,2,3,5,F
940,1989,Portugal,1,40325,60594092182.0,1,2,3,F
941,1989,Qatar,1,39839,6487912088.0,7,5,12,NF
942,1989,Saudi Arabia,3,116540,95344352824.0,7,6,13,NF
943,1989,Somalia,2,78186,1092392963.0,7,7,14,NF
944,1989,South Africa,149,5766169,99030856825.0,6,5,11,PF
945,1989,South Korea,1,38463,247000000000.0,2,3,5,F
946,1989,Spain,142,5504261,415000000000.0,1,1,2,F
947,1989,Sri Lanka,510,19998098,6987267684.0,4,5,9,PF
948,1989,Sudan,8,308803,15291507937.0,7,7,14,NF
949,1989,Suriname,17,666170,542600000.0,3,3,6,PF
950,1989,Sweden,3,122673,218000000000.0,1,1,2,F
951,1989,Syria,1,36932,18609532294.0,7,7,14,NF
952,1989,Thailand,16,619983,72250877410.0,2,3,5,F
953,1989,Trinidad and Tobago,1,39569,4323058824.0,1,1,2,F
954,1989,Turkey,114,4460245,107000000000.0,3,3,6,PF
955,1989,Uganda,15,571940,5276480986.0,6,4,10,PF
956,1989,United Arab Emirates,1,38502,41464995914.0,6,5,11,NF
957,1989,United Kingdom,163,6324490,927000000000.0,1,1,2,F
958,1989,United States,42,1629959,5640000000000.0,1,1,2,F
959,1989,Uruguay,1,40042,8438951476.0,1,2,3,F
960,1989,Zambia,18,688915,3998637681.0,6,5,11,PF
961,1989,Zimbabwe,3,112547,8286322700.0,6,4,10,PF
963,1990,Albania,1,43168,2028553750.0,7,6,13,NF
964,1990,Algeria,2,83496,62048562947.0,4,4,8,PF
965,1990,Angola,205,8864101,11236275843.0,7,7,14,NF
966,1990,Argentina,31,1345576,141000000000.0,1,3,4,F
967,1990,Austria,1,42990,166000000000.0,1,1,2,F
968,1990,Bangladesh,22,950121,31598341234.0,5,5,10,PF
969,1990,Belgium,2,83388,205000000000.0,1,1,2,F
970,1990,Bolivia,11,473855,4867582620.0,2,3,5,F
971,1990,Botswana,1,42237,3790567052.0,1,2,3,F
972,1990,Brazil,7,309380,391000000000.0,2,3,5,F
973,1990,Bulgaria,5,222750,20632090909.0,3,4,7,PF
975,1990,Chile,161,6939043,33113887818.0,2,2,4,F
976,1990,China,1,44801,361000000000.0,7,7,14,NF
977,1990,Colombia,349,14886229,47844090710.0,3,4,7,PF
978,1990,Costa Rica,1,42559,5711687787.0,1,1,2,F
979,1990,Cyprus,11,481822,5591130218.0,1,1,2,F
980,1990,Djibouti,1,44124,452328087.3,6,5,11,NF
981,1990,Dominican Republic,2,88193,7073675545.0,2,3,5,F
982,1990,Ecuador,8,342967,15239278100.0,2,2,4,F
983,1990,Egypt,13,553422,42978914311.0,5,4,9,PF
984,1990,El Salvador,184,7927514,4817542204.0,3,4,7,PF
985,1990,Ethiopia,10,418978,12175166763.0,7,7,14,NF
986,1990,France,30,1319090,1270000000000.0,1,2,3,F
987,1990,Germany,1,44192,1770000000000.0,1,2,3,F
988,1990,Greece,55,2342548,97891092003.0,1,2,3,F
989,1990,Guatemala,83,3556531,7650125217.0,3,4,7,PF
990,1990,Guyana,5,206920,396582263.3,5,4,9,PF
991,1990,Haiti,3,132605,3096289800.0,4,4,8,PF
992,1990,Honduras,13,564380,4923009552.0,2,3,5,F
993,1990,India,349,14897251,321000000000.0,2,3,5,F
994,1990,Indonesia,3,128995,106000000000.0,6,5,11,PF
995,1990,Iran,11,469981,125000000000.0,6,5,11,NF
996,1990,Ireland,2,83795,49305632408.0,1,1,2,F
998,1990,Italy,6,263505,1180000000000.0,1,1,2,F
999,1990,Japan,93,4058903,3130000000000.0,1,1,2,F
1000,1990,Jordan,3,127295,4160003917.0,5,5,10,PF
1001,1990,Lebanon,84,3604233,2838485354.0,6,5,11,NF
1003,1990,Malaysia,3,131154,44024178343.0,5,4,9,PF
1004,1990,Mali,1,43124,2681959313.0,6,5,11,NF
1005,1990,Mexico,5,210232,261000000000.0,4,4,8,PF
1007,1990,Myanmar,9,382903,21227553397.0,7,7,14,NF
1008,1990,Namibia,2,86081,2789944498.0,2,3,5,F
1009,1990,Netherlands,6,258861,318000000000.0,1,1,2,F
1010,1990,Nicaragua,15,647593,1009455484.0,3,3,6,PF
1011,1990,Pakistan,87,3731961,40010423970.0,4,4,8,PF
1012,1990,Panama,15,646158,6433967000.0,4,2,6,PF
1013,1990,Papua New Guinea,18,747297,3219730365.0,2,3,5,F
1014,1990,Peru,495,21245406,26410386669.0,3,4,7,PF
1015,1990,Philippines,320,13874796,50508286643.0,3,3,6,PF
1016,1990,Poland,7,300352,65977749037.0,2,2,4,F
1017,1990,Senegal,11,476950,7390967035.0,4,3,7,PF
1018,1990,Somalia,12,525861,917044228.0,7,7,14,NF
1019,1990,South Africa,154,6619553,116000000000.0,5,4,9,PF
1020,1990,South Korea,3,127146,283000000000.0,2,3,5,F
1021,1990,Spain,113,4895430,537000000000.0,1,1,2,F
1022,1990,Sri Lanka,141,6094583,8032551173.0,4,5,9,PF
1023,1990,Sudan,1,41361,12408647541.0,7,7,14,NF
1024,1990,Suriname,7,297025,388400000.0,6,4,10,PF
1025,1990,Sweden,6,256396,262000000000.0,1,1,2,F
1026,1990,Switzerland,1,42247,266000000000.0,1,1,2,F
1027,1990,Thailand,10,431998,85343063966.0,2,3,5,F
1028,1990,Turkey,195,8411942,151000000000.0,2,4,6,PF
1029,1990,Uganda,14,595683,4304398866.0,6,5,11,PF
1030,1990,United Kingdom,147,6316326,1090000000000.0,1,2,3,F
1031,1990,United States,32,1368792,5960000000000.0,1,1,2,F
1032,1990,Uruguay,1,44399,9298839655.0,1,2,3,F
1033,1990,Zambia,4,175358,3285217391.0,6,5,11,PF
1034,1990,Zimbabwe,6,249674,8783816700.0,6,4,10,PF
1036,1991,Albania,1,48025,1099559028.0,4,4,8,PF
1037,1991,Algeria,30,1419767,45715614560.0,4,4,8,PF
1039,1991,Argentina,27,1269000,190000000000.0,1,3,4,F
1040,1991,Armenia,1,49471,2069870130.0,5,5,10,PF
1041,1991,Australia,4,186766,326000000000.0,1,1,2,F
1042,1991,Austria,3,143497,174000000000.0,1,1,2,F
1044,1991,Bahrain,1,49637,4616223404.0,6,5,11,PF
1045,1991,Bangladesh,42,2007221,30957483950.0,2,3,5,F
1046,1991,Belgium,6,285874,211000000000.0,1,1,2,F
1047,1991,Belize,3,140222,444720750.0,1,1,2,F
1048,1991,Bolivia,28,1337357,5343274312.0,2,3,5,F
1049,1991,Brazil,24,1125428,343000000000.0,2,3,5,F
1050,1991,Bulgaria,3,141011,10943548387.0,2,3,5,F
1051,1991,Burkina Faso,2,98791,3135045684.0,6,5,11,NF
1052,1991,Burundi,7,344548,1167398478.0,7,6,13,NF
1054,1991,Cameroon,4,189248,11840192674.0,6,6,12,NF
1055,1991,Central African Republic,4,190256,1377375031.0,6,5,11,PF
1056,1991,Chad,2,94519,1877138042.0,6,6,12,NF
1057,1991,Chile,127,6010100,37834793730.0,2,2,4,F
1058,1991,China,1,45137,383000000000.0,7,7,14,NF
1059,1991,Colombia,420,19674619,49175565911.0,2,4,6,PF
1060,1991,Costa Rica,2,91981,7196276092.0,1,1,2,F
1062,1991,Cuba,1,46924,24316556026.0,7,7,14,NF
1063,1991,Cyprus,11,509470,5770197348.0,1,1,2,F
1064,1991,Denmark,1,49031,139000000000.0,1,1,2,F
1065,1991,Djibouti,1,49490,462421998.5,6,5,11,NF
1066,1991,Dominican Republic,8,381102,9824498183.0,2,3,5,F
1067,1991,Ecuador,17,799660,16988535268.0,2,3,5,F
1068,1991,Egypt,10,482287,37387836491.0,5,5,10,PF
1069,1991,El Salvador,500,23644707,5252342400.0,3,4,7,PF
1070,1991,Ethiopia,5,242014,13463868357.0,6,5,11,PF
1071,1991,Fiji,3,143372,1383843860.0,6,4,10,PF
1072,1991,France,137,6360191,1270000000000.0,1,2,3,F
1074,1991,Germany,65,3088294,1870000000000.0,1,2,3,F
1075,1991,Greece,57,2645882,105000000000.0,1,2,3,F
1076,1991,Guatemala,77,3616937,9406097735.0,3,5,8,PF
1077,1991,Haiti,17,815204,3473540602.0,7,7,14,NF
1078,1991,Honduras,21,1001782,4648668479.0,2,3,5,F
1079,1991,Hungary,3,145011,34753569693.0,2,2,4,F
1080,1991,India,339,16045086,270000000000.0,3,4,7,PF
1081,1991,Indonesia,7,329783,117000000000.0,6,5,11,PF
1083,1991,Iraq,3,146198,407796349.7,7,7,14,NF
1084,1991,Ireland,16,749316,49787501584.0,1,1,2,F
1086,1991,Italy,31,1456540,1250000000000.0,1,1,2,F
1087,1991,Jamaica,1,47606,4106199176.0,2,2,4,F
1088,1991,Japan,19,897226,3580000000000.0,1,2,3,F
1089,1991,Jordan,11,498158,4344250257.0,4,4,8,PF
1090,1991,Kenya,5,245433,8151479004.0,6,6,12,NF
1091,1991,Kuwait,5,229068,11008793176.0,6,5,11,NF
1092,1991,Lebanon,91,4275683,4690415093.0,6,4,10,PF
1095,1991,Madagascar,1,48730,3254713056.0,4,4,8,PF
1096,1991,Malaysia,3,135702,49143148094.0,5,4,9,PF
1097,1991,Mali,12,571321,2724101611.0,6,4,10,PF
1098,1991,Mexico,10,475900,313000000000.0,4,4,8,PF
1100,1991,Morocco,3,146691,32285388165.0,5,5,10,PF
1101,1991,Mozambique,35,1660717,3633406065.0,6,4,10,PF
1102,1991,Myanmar,22,1036502,27189628556.0,7,7,14,NF
1103,1991,Namibia,1,47175,2996885561.0,2,3,5,F
1104,1991,Nepal,1,47480,3921476085.0,2,3,5,F
1105,1991,Netherlands,8,383495,328000000000.0,1,1,2,F
1106,1991,New Zealand,1,48124,42745329732.0,1,1,2,F
1107,1991,Nicaragua,80,3837031,1488804124.0,3,3,6,PF
1108,1991,Niger,6,286538,3285796980.0,6,5,11,PF
1109,1991,Nigeria,3,142376,49118433048.0,5,4,9,PF
1110,1991,Norway,2,96612,122000000000.0,1,1,2,F
1111,1991,Pakistan,150,7170968,45625234698.0,4,5,9,PF
1112,1991,Panama,16,760720,7074675500.0,4,2,6,PF
1113,1991,Papua New Guinea,2,91322,3787394958.0,2,3,5,F
1114,1991,Peru,658,31235485,34341465998.0,3,5,8,PF
1115,1991,Philippines,162,7630594,51784207132.0,3,3,6,PF
1116,1991,Romania,1,47801,28998684211.0,5,5,10,PF
1117,1991,Rwanda,3,138740,1911600970.0,6,6,12,NF
1118,1991,Saudi Arabia,2,91328,132000000000.0,7,6,13,NF
1119,1991,Senegal,4,186887,7255210701.0,4,3,7,PF
1120,1991,Sierra Leone,9,415656,779981458.9,6,5,11,PF
1121,1991,Singapore,1,45902,45466164978.0,4,4,8,PF
1123,1991,South Africa,127,6055363,124000000000.0,5,4,9,PF
1124,1991,South Korea,6,284607,331000000000.0,2,3,5,F
1125,1991,Spain,89,4190433,577000000000.0,1,1,2,F
1126,1991,Sri Lanka,115,5386258,9000362582.0,4,5,9,PF
1127,1991,Sudan,3,144816,11379222222.0,7,7,14,NF
1128,1991,Suriname,1,49048,448100000.0,4,4,8,PF
1129,1991,Sweden,6,296485,274000000000.0,1,1,2,F
1130,1991,Switzerland,2,93348,269000000000.0,1,1,2,F
1131,1991,Thailand,8,368058,98234695722.0,6,4,10,PF
1132,1991,Togo,2,97784,1602299863.0,6,5,11,NF
1133,1991,Trinidad and Tobago,1,46660,5307905882.0,1,1,2,F
1134,1991,Tunisia,2,90817,13074782609.0,5,5,10,PF
1135,1991,Turkey,293,13858961,150000000000.0,2,4,6,PF
1136,1991,Uganda,2,94291,3321729057.0,6,6,12,NF
1138,1991,United Kingdom,262,12524679,1140000000000.0,1,2,3,F
1139,1991,United States,30,1396724,6160000000000.0,1,1,2,F
1140,1991,Uruguay,3,136871,11205971155.0,1,2,3,F
1141,1991,Zimbabwe,1,47319,8641481700.0,5,4,9,PF
1143,1992,Albania,3,153185,652174990.8,4,3,7,PF
1144,1992,Algeria,215,11234098,48003078389.0,7,6,13,NF
1146,1992,Antigua and Barbuda,1,50418,499281481.5,3,3,6,PF
1147,1992,Argentina,41,2161792,229000000000.0,2,3,5,F
1148,1992,Armenia,2,102492,1272835453.0,4,3,7,PF
1149,1992,Australia,4,207017,325000000000.0,1,1,2,F
1150,1992,Austria,8,415227,195000000000.0,1,1,2,F
1151,1992,Azerbaijan,12,607793,446305555.6,5,5,10,PF
1152,1992,Bangladesh,76,3995516,31708874594.0,2,3,5,F
1153,1992,Barbados,1,50315,1957000000.0,1,1,2,F
1154,1992,Belgium,9,464588,235000000000.0,1,1,2,F
1155,1992,Belize,2,109282,518559700.0,1,1,2,F
1156,1992,Benin,1,54692,1695315306.0,2,3,5,F
1157,1992,Bolivia,38,1979243,5643893347.0,2,3,5,F
1159,1992,Brazil,24,1249008,328000000000.0,2,3,5,F
1160,1992,Brunei,1,51830,4183548189.0,7,6,13,NF
1161,1992,Bulgaria,2,105557,10350515464.0,2,3,5,F
1162,1992,Burundi,2,101356,1083037671.0,6,5,11,PF
1164,1992,Cameroon,6,309706,12071775381.0,6,5,11,NF
1165,1992,Canada,3,154048,592000000000.0,1,1,2,F
1166,1992,Central African Republic,1,53615,1411917558.0,6,5,11,PF
1167,1992,Chad,4,205644,1881847677.0,6,6,12,NF
1168,1992,Chile,116,6055038,45964327559.0,2,2,4,F
1169,1992,China,5,257315,427000000000.0,7,7,14,NF
1170,1992,Colombia,523,27550325,58418985443.0,2,4,6,PF
1171,1992,Comoros,1,53410,457388578.9,4,2,6,PF
1172,1992,Costa Rica,2,104462,8564044017.0,1,1,2,F
1174,1992,Cuba,4,212438,22085858243.0,7,7,14,NF
1175,1992,Cyprus,6,309312,6912150456.0,1,1,2,F
1176,1992,Denmark,4,205081,153000000000.0,1,1,2,F
1177,1992,Djibouti,6,302899,478058304.9,6,6,12,NF
1178,1992,Dominican Republic,11,583720,11605382504.0,2,3,5,F
1179,1992,Ecuador,23,1204120,18094238119.0,2,3,5,F
1180,1992,Egypt,79,4148598,41855986519.0,5,6,11,PF
1181,1992,El Salvador,29,1494443,5813399300.0,3,3,6,PF
1182,1992,Equatorial Guinea,1,51254,134707184.4,7,6,13,NF
1184,1992,Ethiopia,13,665758,10492993078.0,6,4,10,PF
1185,1992,Fiji,1,50034,1532401863.0,4,3,7,PF
1186,1992,Finland,1,50774,113000000000.0,1,1,2,F
1187,1992,France,126,6693374,1400000000000.0,1,2,3,F
1189,1992,Germany,156,8215432,2130000000000.0,1,2,3,F
1190,1992,Ghana,8,430939,6413901602.0,5,5,10,PF
1191,1992,Greece,35,1833429,116000000000.0,1,2,3,F
1192,1992,Guatemala,48,2477001,10440842165.0,4,5,9,PF
1193,1992,Guinea,2,103615,3284620543.0,6,5,11,PF
1194,1992,Guyana,4,210483,373573141.5,3,3,6,PF
1195,1992,Haiti,27,1410189,2257121668.0,7,7,14,NF
1196,1992,Honduras,12,620198,4943700431.0,2,3,5,F
1197,1992,Hungary,1,52489,38730585922.0,2,2,4,F
1198,1992,India,237,12321966,288000000000.0,3,4,7,PF
1199,1992,Indonesia,4,208029,128000000000.0,6,5,11,PF
1201,1992,Iraq,35,1850690,553671957.7,7,7,14,NF
1202,1992,Ireland,7,377234,55918538121.0,1,1,2,F
1204,1992,Italy,37,1928712,1320000000000.0,1,2,3,F
1205,1992,Jamaica,6,313748,3535460090.0,2,2,4,F
1206,1992,Japan,40,2094891,3910000000000.0,1,2,3,F
1207,1992,Jordan,2,106579,5311329067.0,3,3,6,PF
1208,1992,Kazakhstan,5,265388,24917355372.0,5,5,10,PF
1209,1992,Kenya,30,1554304,8209129172.0,4,5,9,PF
1210,1992,Kuwait,15,788651,19858555215.0,5,5,10,PF
1212,1992,Lebanon,91,4737332,5843579161.0,5,4,9,PF
1214,1992,Libya,1,50896,33881392045.0,7,7,14,NF
1216,1992,Madagascar,7,363364,3714967007.0,4,4,8,PF
1217,1992,Malawi,3,156583,1799517082.0,6,7,13,NF
1218,1992,Malaysia,2,104532,59167550163.0,5,4,9,PF
1219,1992,Mali,3,156178,2830692639.0,2,3,5,F
1220,1992,Malta,1,50447,3021910217.0,1,1,2,F
1221,1992,Mexico,6,315762,363000000000.0,4,3,7,PF
1223,1992,Morocco,1,51138,33711069431.0,6,5,11,PF
1224,1992,Mozambique,19,976100,2639953231.0,6,4,10,PF
1225,1992,Myanmar,12,620174,35595770696.0,7,7,14,NF
1226,1992,Nepal,8,410242,3401211581.0,2,3,5,F
1227,1992,Netherlands,12,604440,363000000000.0,1,1,2,F
1228,1992,Nicaragua,30,1554430,1792800000.0,4,3,7,PF
1229,1992,Niger,16,831499,3386232592.0,5,4,9,PF
1230,1992,Nigeria,11,564379,47794925815.0,5,4,9,PF
1231,1992,Norway,2,101612,131000000000.0,1,1,2,F
1232,1992,Pakistan,85,4387319,48884606848.0,4,5,9,PF
1233,1992,Panama,37,1919091,8042337700.0,4,3,7,PF
1234,1992,Papua New Guinea,10,523681,4377980510.0,2,3,5,F
1235,1992,Paraguay,4,211270,7157424031.0,3,3,6,PF
1236,1992,Peru,383,19961778,35966302303.0,6,5,11,PF
1237,1992,Philippines,162,8371947,60422309297.0,3,3,6,PF
1238,1992,Poland,5,264693,94337050693.0,2,2,4,F
1239,1992,Portugal,1,50271,108000000000.0,1,1,2,F
1240,1992,Romania,1,51223,25121666667.0,4,4,8,PF
1241,1992,Russia,21,1088472,460000000000.0,3,4,7,PF
1242,1992,Rwanda,18,926251,2029026704.0,6,5,11,NF
1243,1992,Senegal,15,799831,7769817869.0,4,3,7,PF
1244,1992,Sierra Leone,4,210563,679997997.6,7,6,13,NF
1245,1992,Singapore,1,50817,52130263966.0,4,5,9,PF
1247,1992,South Africa,271,14012153,135000000000.0,5,4,9,PF
1248,1992,South Korea,3,157018,356000000000.0,2,3,5,F
1249,1992,Spain,72,3726140,631000000000.0,1,1,2,F
1250,1992,Sri Lanka,103,5344441,9703011636.0,4,5,9,PF
1251,1992,Sudan,7,369124,7034219713.0,7,7,14,NF
1252,1992,Suriname,5,271355,404600000.0,3,3,6,PF
1253,1992,Sweden,12,616283,284000000000.0,1,1,2,F
1254,1992,Switzerland,6,303015,280000000000.0,1,1,2,F
1255,1992,Tajikistan,17,911344,2156666667.0,6,6,12,NF
1256,1992,Thailand,25,1304514,111000000000.0,3,4,7,PF
1257,1992,Togo,27,1410678,1692959110.0,6,5,11,NF
1258,1992,Trinidad and Tobago,1,50991,5439552941.0,1,1,2,F
1259,1992,Turkey,514,26752528,158000000000.0,2,4,6,PF
1260,1992,Uganda,3,157840,2857457860.0,6,5,11,NF
1261,1992,Ukraine,1,50830,71900000000.0,3,3,6,PF
1262,1992,United Arab Emirates,1,52392,54239171888.0,6,5,11,PF
1263,1992,United Kingdom,274,14212004,1180000000000.0,1,2,3,F
1264,1992,United States,32,1670980,6520000000000.0,1,1,2,F
1265,1992,Uruguay,11,586621,12878199881.0,1,2,3,F
1266,1992,Uzbekistan,2,103373,12941297376.0,6,6,12,NF
1267,1992,Vietnam,1,52818,9866990236.0,7,7,14,NF
1268,1992,Zimbabwe,1,51601,6751472200.0,5,4,9,PF
1270,1994,Albania,2,111085,1880951520.0,3,4,7,PF
1271,1994,Algeria,227,12783255,42543178042.0,7,7,14,NF
1272,1994,Angola,9,505451,3390500000.0,7,7,14,NF
1273,1994,Argentina,14,792967,257000000000.0,2,3,5,F
1274,1994,Armenia,4,225770,1315158637.0,3,4,7,PF
1275,1994,Australia,9,506864,323000000000.0,1,1,2,F
1276,1994,Austria,5,286843,204000000000.0,1,1,2,F
1277,1994,Azerbaijan,11,620407,1193312102.0,6,6,12,NF
1278,1994,Bahrain,1,57835,5567553457.0,6,6,12,NF
1279,1994,Bangladesh,68,3929588,33768660883.0,2,4,6,PF
1280,1994,Belarus,1,56581,17793000000.0,4,4,8,PF
1281,1994,Belgium,5,278021,245000000000.0,1,1,2,F
1282,1994,Benin,3,171139,1598075932.0,2,3,5,F
1283,1994,Bolivia,8,452006,5981244887.0,2,3,5,F
1284,1994,Bosnia-Herzegovina,9,511641,1255802469.0,6,6,12,NF
1285,1994,Brazil,19,1085753,525000000000.0,2,4,6,PF
1286,1994,Bulgaria,2,112844,9697416974.0,2,2,4,F
1287,1994,Burundi,16,910101,925030590.2,6,7,13,NF
1288,1994,Cambodia,39,2221442,2791435272.0,4,5,9,PF
1289,1994,Cameroon,6,331743,8902446188.0,6,5,11,NF
1290,1994,Canada,4,224444,578000000000.0,1,1,2,F
1291,1994,Central African Republic,1,57663,851174350.6,3,4,7,PF
1292,1994,Chad,1,54746,1179837955.0,6,5,11,NF
1293,1994,Chile,15,847752,57008425296.0,2,2,4,F
1294,1994,China,13,736370,564000000000.0,7,7,14,NF
1295,1994,Colombia,201,11335107,81703500846.0,3,4,7,PF
1296,1994,Comoros,1,55584,319189200.4,4,4,8,PF
1297,1994,Costa Rica,1,57770,10486784805.0,1,2,3,F
1299,1994,Cuba,9,511057,28448326757.0,7,7,14,NF
1300,1994,Cyprus,6,336029,7425703929.0,1,1,2,F
1301,1994,Czech Republic,1,56931,47850203856.0,1,2,3,F
1302,1994,Djibouti,2,113309,491689220.7,6,6,12,NF
1303,1994,Dominican Republic,7,393340,14644711385.0,4,3,7,PF
1304,1994,Ecuador,6,339705,22708673337.0,2,3,5,F
1305,1994,Egypt,143,8097560,51897983393.0,6,6,12,NF
1306,1994,El Salvador,21,1180574,7679384000.0,3,3,6,PF
1308,1994,Ethiopia,4,224898,6927950565.0,6,5,11,NF
1309,1994,Finland,1,55691,103000000000.0,1,1,2,F
1310,1994,France,97,5482389,1390000000000.0,1,2,3,F
1311,1994,Gabon,1,55307,4190819314.0,5,4,9,PF
1312,1994,Georgia,18,1012578,2514070772.0,5,5,10,PF
1313,1994,Germany,79,4467780,2210000000000.0,1,2,3,F
1314,1994,Ghana,4,222853,5444560669.0,5,4,9,PF
1315,1994,Greece,42,2376258,117000000000.0,1,3,4,F
1316,1994,Guatemala,84,4721643,12983235568.0,4,5,9,PF
1317,1994,Guinea,2,110347,3383092828.0,6,5,11,NF
1318,1994,Haiti,27,1542992,2167564195.0,5,5,10,PF
1319,1994,Honduras,6,339210,4642280682.0,3,3,6,PF
1320,1994,Hungary,2,113441,43166678735.0,1,2,3,F
1321,1994,India,107,6071718,327000000000.0,4,4,8,PF
1322,1994,Indonesia,5,284528,177000000000.0,7,6,13,NF
1323,1994,Iran,43,2395775,71841461173.0,6,7,13,NF
1324,1994,Iraq,18,1021516,3991349283.0,7,7,14,NF
1325,1994,Ireland,10,558385,57097656066.0,1,2,3,F
1327,1994,Italy,18,1017713,1100000000000.0,1,2,3,F
1328,1994,Jamaica,2,114943,5452564385.0,2,3,5,F
1329,1994,Japan,9,513072,5000000000000.0,2,2,4,F
1330,1994,Jordan,6,337197,6237739516.0,4,4,8,PF
1331,1994,Kazakhstan,1,57609,21250792886.0,6,5,11,NF
1332,1994,Kenya,5,282100,7148145376.0,6,6,12,NF
1333,1994,Kuwait,2,110106,24848483838.0,5,5,10,PF
1335,1994,Lebanon,67,3790084,9599127050.0,6,5,11,PF
1336,1994,Lesotho,3,168667,878250450.6,4,4,8,PF
1338,1994,Luxembourg,3,167870,17701798891.0,1,1,2,F
1339,1994,Mali,13,742878,2081864106.0,2,4,6,PF
1340,1994,Mexico,42,2352708,528000000000.0,4,4,8,PF
1342,1994,Morocco,2,112341,35604137423.0,5,5,10,PF
1343,1994,Mozambique,3,170582,2796549978.0,3,5,8,PF
1344,1994,Myanmar,8,457167,68807734001.0,7,7,14,NF
1345,1994,Namibia,1,57631,3666501464.0,2,3,5,F
1346,1994,Nepal,3,173258,4066775510.0,3,4,7,PF
1347,1994,Netherlands,3,170975,379000000000.0,1,1,2,F
1348,1994,New Zealand,1,57255,55314732279.0,1,1,2,F
1349,1994,Nicaragua,19,1081125,3863185119.0,4,5,9,PF
1350,1994,Niger,8,447197,1938058161.0,3,5,8,PF
1351,1994,Nigeria,8,454713,33833042988.0,7,6,13,NF
1353,1994,Norway,2,114760,127000000000.0,1,1,2,F
1354,1994,Pakistan,154,8823945,52293456906.0,3,5,8,PF
1355,1994,Panama,3,168610,9365289800.0,2,3,5,F
1356,1994,Papua New Guinea,3,170959,5502786070.0,2,4,6,PF
1357,1994,Paraguay,2,114957,7870982005.0,4,3,7,PF
1358,1994,Peru,91,5134018,44882079767.0,5,4,9,PF
1359,1994,Philippines,72,4078172,73159245524.0,3,4,7,PF
1360,1994,Poland,4,227912,111000000000.0,2,2,4,F
1361,1994,Portugal,1,57256,99688641304.0,1,1,2,F
1362,1994,Russia,47,2660822,395000000000.0,3,4,7,PF
1363,1994,Rwanda,33,1853881,753636370.5,7,7,14,NF
1364,1994,Saudi Arabia,2,111517,135000000000.0,7,7,14,NF
1365,1994,Senegal,2,110163,5034588159.0,4,5,9,PF
1366,1994,Sierra Leone,22,1239927,911915970.7,7,6,13,NF
1367,1994,Singapore,1,56494,73690847191.0,5,5,10,PF
1370,1994,South Africa,174,9734973,154000000000.0,2,3,5,F
1371,1994,South Korea,2,113903,464000000000.0,2,2,4,F
1372,1994,Spain,55,3094391,531000000000.0,1,2,3,F
1373,1994,Sri Lanka,35,1991396,11717604209.0,4,5,9,PF
1374,1994,Sudan,5,280734,12794192334.0,7,7,14,NF
1375,1994,Suriname,1,55643,605492537.3,3,3,6,PF
1376,1994,Sweden,1,54722,229000000000.0,1,1,2,F
1377,1994,Tajikistan,31,1761960,1518796992.0,7,7,14,NF
1378,1994,Tanzania,1,55653,4510846968.0,6,6,12,NF
1379,1994,Thailand,24,1349089,147000000000.0,3,5,8,PF
1380,1994,Togo,13,729303,982624324.5,6,5,11,NF
1381,1994,Trinidad and Tobago,1,56243,4947205860.0,1,2,3,F
1382,1994,Tunisia,1,55784,15632463424.0,6,5,11,NF
1383,1994,Turkey,300,16830556,131000000000.0,5,5,10,PF
1384,1994,Uganda,13,734504,3990430447.0,5,5,10,PF
1385,1994,Ukraine,10,566542,52543387167.0,3,4,7,PF
1386,1994,United Kingdom,256,14333828,1140000000000.0,1,2,3,F
1387,1994,United States,55,3130686,7290000000000.0,1,1,2,F
1388,1994,Uruguay,4,229898,17474647792.0,2,2,4,F
1389,1994,Vietnam,1,57511,16286433533.0,7,7,14,NF
1390,1994,Zimbabwe,1,56627,6890675000.0,5,5,10,PF
1392,1995,Algeria,185,11038159,41764315330.0,6,6,12,NF
1393,1995,Angola,10,596841,5561222222.0,6,6,12,NF
1394,1995,Argentina,16,961843,258000000000.0,2,3,5,F
1395,1995,Armenia,1,59881,1468317435.0,4,4,8,PF
1396,1995,Australia,5,298927,368000000000.0,1,1,2,F
1397,1995,Austria,12,713786,241000000000.0,1,1,2,F
1398,1995,Azerbaijan,2,120889,2417355840.0,6,6,12,NF
1399,1995,Bahrain,8,468889,5849467819.0,6,6,12,NF
1400,1995,Bangladesh,74,4448805,37939748769.0,3,4,7,PF
1401,1995,Belgium,1,58284,288000000000.0,1,1,2,F
1402,1995,Benin,1,60930,2169627251.0,2,2,4,F
1403,1995,Bolivia,2,119068,6715220507.0,2,4,6,PF
1404,1995,Bosnia-Herzegovina,6,356626,1866572954.0,6,6,12,NF
1405,1995,Botswana,1,58342,4730611067.0,2,2,4,F
1406,1995,Brazil,23,1367687,769000000000.0,2,4,6,PF
1407,1995,Bulgaria,2,119871,18983303571.0,2,2,4,F
1408,1995,Burundi,83,4968320,1000428394.0,6,7,13,NF
1409,1995,Cambodia,56,3336810,3441205693.0,6,6,12,NF
1410,1995,Cameroon,2,118202,10864773037.0,7,5,12,NF
1411,1995,Canada,5,301319,604000000000.0,1,1,2,F
1412,1995,Chad,3,176996,1445919970.0,6,5,11,NF
1413,1995,Chile,17,1027654,73447063319.0,2,2,4,F
1414,1995,China,8,475958,735000000000.0,7,7,14,NF
1415,1995,Colombia,123,7360910,92507279383.0,4,4,8,PF
1416,1995,Croatia,1,60745,22717081925.0,4,4,8,PF
1417,1995,Cyprus,3,181372,9933133247.0,1,1,2,F
1418,1995,Czech Republic,3,180393,60147174077.0,1,2,3,F
1419,1995,Denmark,6,350905,185000000000.0,1,1,2,F
1420,1995,Djibouti,2,119489,497723960.6,5,6,11,NF
1421,1995,Ecuador,6,361614,24432884442.0,2,3,5,F
1422,1995,Egypt,102,6069412,60159245060.0,6,6,12,NF
1423,1995,El Salvador,9,531712,8921947100.0,3,3,6,PF
1424,1995,Eritrea,2,117302,578015625.0,6,4,10,PF
1425,1995,Estonia,2,121088,4502970889.0,2,2,4,F
1426,1995,Ethiopia,5,296803,7663984568.0,4,5,9,PF
1427,1995,Finland,1,60196,134000000000.0,1,1,2,F
1428,1995,France,71,4281741,1600000000000.0,1,2,3,F
1429,1995,Georgia,17,1011455,2693768413.0,4,5,9,PF
1430,1995,Germany,147,8758730,2590000000000.0,1,2,3,F
1431,1995,Ghana,1,60021,6465137615.0,4,4,8,PF
1432,1995,Greece,8,479439,137000000000.0,1,3,4,F
1433,1995,Guatemala,82,4862075,14655404433.0,4,5,9,PF
1434,1995,Haiti,34,2027950,2813313279.0,5,5,10,PF
1435,1995,Honduras,12,718713,5347445005.0,3,3,6,PF
1436,1995,India,179,10639946,360000000000.0,4,4,8,PF
1437,1995,Indonesia,24,1446105,202000000000.0,7,6,13,NF
1438,1995,Iran,8,479669,96419225744.0,6,7,13,NF
1439,1995,Iraq,17,1013778,12894029888.0,7,7,14,NF
1440,1995,Ireland,3,179642,69139823232.0,1,1,2,F
1441,1995,Israel,12,708985,101000000000.0,1,3,4,F
1442,1995,Italy,1,58189,1170000000000.0,1,2,3,F
1443,1995,Jamaica,1,59103,6577523825.0,2,3,5,F
1444,1995,Japan,20,1182977,5550000000000.0,1,2,3,F
1445,1995,Jordan,3,179862,6727446632.0,4,4,8,PF
1446,1995,Kenya,4,240882,9046326060.0,7,6,13,NF
1447,1995,Latvia,1,59104,5789128637.0,2,2,4,F
1448,1995,Lebanon,38,2275994,11718795528.0,6,5,11,NF
1449,1995,Libya,1,59998,25544128199.0,7,7,14,NF
1450,1995,Lithuania,2,120868,7867140395.0,1,2,3,F
1451,1995,Madagascar,3,178252,3838101052.0,2,4,6,PF
1452,1995,Mali,1,58327,2706416623.0,2,3,5,F
1453,1995,Malta,2,121603,3720400535.0,1,1,2,F
1454,1995,Mexico,29,1718264,360000000000.0,4,4,8,PF
1455,1995,Morocco,1,58637,39030285468.0,5,5,10,PF
1456,1995,Mozambique,3,177832,2899922842.0,3,4,7,PF
1457,1995,Myanmar,12,709046,94641791002.0,7,7,14,NF
1458,1995,Netherlands,7,415549,452000000000.0,1,1,2,F
1459,1995,Nicaragua,18,1073065,4140470000.0,4,4,8,PF
1460,1995,Niger,2,119873,2302537682.0,3,5,8,PF
1461,1995,Nigeria,1,60596,44062465800.0,7,7,14,NF
1462,1995,Pakistan,666,39815013,60636022423.0,3,5,8,PF
1463,1995,Panama,6,359040,9573813700.0,2,3,5,F
1464,1995,Papua New Guinea,10,603019,4636057476.0,2,4,6,PF
1465,1995,Paraguay,12,725663,9062131475.0,4,3,7,PF
1466,1995,Peru,44,2612432,53312793687.0,5,4,9,PF
1467,1995,Philippines,63,3765582,84644220102.0,2,4,6,PF
1468,1995,Poland,4,236227,142000000000.0,1,2,3,F
1469,1995,Portugal,3,178811,118000000000.0,1,1,2,F
1470,1995,Romania,1,59508,37435317265.0,4,3,7,PF
1471,1995,Russia,37,2219312,396000000000.0,3,4,7,PF
1472,1995,Rwanda,17,1014103,1293535011.0,7,6,13,NF
1473,1995,Saudi Arabia,3,182497,143000000000.0,7,7,14,NF
1474,1995,Senegal,8,471765,6326342963.0,4,5,9,PF
1475,1995,Sierra Leone,14,822021,870758739.4,7,6,13,NF
1477,1995,South Africa,32,1906172,172000000000.0,1,2,3,F
1478,1995,South Korea,4,237547,567000000000.0,2,2,4,F
1479,1995,Spain,44,2633609,615000000000.0,1,2,3,F
1480,1995,Sri Lanka,126,7576014,13029697561.0,4,5,9,PF
1481,1995,St. Kitts and Nevis,2,119317,313485185.2,1,2,3,F
1482,1995,Sudan,4,236238,13829744879.0,7,7,14,NF
1483,1995,Sweden,1,58825,267000000000.0,1,1,2,F
1484,1995,Switzerland,5,298460,353000000000.0,1,1,2,F
1485,1995,Tajikistan,34,2018219,1231040564.0,7,7,14,NF
1486,1995,Tanzania,1,60025,5255221425.0,5,5,10,PF
1487,1995,Thailand,12,714868,169000000000.0,3,4,7,PF
1488,1995,Togo,1,59346,1309382885.0,6,5,11,NF
1489,1995,Trinidad and Tobago,4,239187,5329214163.0,1,2,3,F
1490,1995,Tunisia,1,58449,18030876599.0,6,5,11,NF
1491,1995,Turkey,133,7921044,169000000000.0,5,5,10,PF
1492,1995,Uganda,7,415653,5755818947.0,5,4,9,PF
1493,1995,Ukraine,2,117706,48214751924.0,3,4,7,PF
1494,1995,United Arab Emirates,2,120895,65743666576.0,6,5,11,NF
1495,1995,United Kingdom,22,1316890,1350000000000.0,1,2,3,F
1496,1995,United States,60,3565570,7640000000000.0,1,1,2,F
1497,1995,Uruguay,1,60412,19297663097.0,2,2,4,F
1498,1995,Uzbekistan,1,58310,13350468917.0,7,7,14,NF
1499,1995,Vietnam,1,60871,20736164459.0,7,7,14,NF
1500,1995,Zambia,1,59125,3807067122.0,3,4,7,PF
1501,1995,Zimbabwe,2,121531,7111270700.0,5,5,10,PF
1503,1996,Albania,6,374632,3199641336.0,4,4,8,PF
1504,1996,Algeria,129,8110467,46941582519.0,6,6,12,NF
1505,1996,Angola,4,251816,7526963964.0,6,6,12,NF
1506,1996,Argentina,19,1203655,272000000000.0,2,3,5,F
1507,1996,Armenia,1,63181,1596968946.0,5,4,9,PF
1508,1996,Australia,5,317535,401000000000.0,1,1,2,F
1509,1996,Austria,4,250745,237000000000.0,1,1,2,F
1510,1996,Azerbaijan,2,123501,3176333837.0,6,5,11,NF
1511,1996,Bahrain,16,994933,6101861436.0,7,6,13,NF
1512,1996,Bangladesh,161,9979945,46438484108.0,2,4,6,PF
1513,1996,Benin,2,123568,2361116588.0,2,2,4,F
1514,1996,Bolivia,1,62098,7396966657.0,2,3,5,F
1515,1996,Bosnia-Herzegovina,33,2095194,2786045322.0,5,5,10,PF
1516,1996,Brazil,18,1129719,850000000000.0,2,4,6,PF
1517,1996,Bulgaria,12,756038,12294221473.0,2,3,5,F
1518,1996,Burundi,35,2192079,869033856.3,7,7,14,NF
1519,1996,Cambodia,33,2066393,3506695720.0,6,6,12,NF
1520,1996,Canada,1,62252,629000000000.0,1,1,2,F
1521,1996,Central African Republic,1,64113,1007791186.0,3,5,8,PF
1522,1996,Chad,1,63129,1607345450.0,6,5,11,NF
1523,1996,Chile,8,507734,78039572222.0,2,2,4,F
1524,1996,China,62,3898810,864000000000.0,7,7,14,NF
1525,1996,Colombia,409,25800281,97160109278.0,4,4,8,PF
1526,1996,Costa Rica,1,63212,11678424507.0,1,2,3,F
1527,1996,Croatia,3,189850,24075166261.0,4,4,8,PF
1528,1996,Cuba,1,64078,25017368700.0,7,7,14,NF
1529,1996,Cyprus,10,628770,10011918444.0,1,1,2,F
1530,1996,Czech Republic,3,190882,67387788633.0,1,2,3,F
1531,1996,Dominican Republic,3,190373,18241691857.0,3,3,6,PF
1532,1996,Ecuador,5,311419,25226393197.0,2,4,6,PF
1533,1996,Egypt,51,3195369,67629716981.0,6,6,12,NF
1534,1996,El Salvador,7,444770,9586327800.0,3,3,6,PF
1535,1996,Eritrea,1,64302,693535954.2,6,4,10,PF
1536,1996,Estonia,1,61552,4786018988.0,1,2,3,F
1537,1996,Ethiopia,7,437202,8547939731.0,4,5,9,PF
1538,1996,France,270,16950240,1610000000000.0,1,2,3,F
1539,1996,Gabon,1,63974,5694040337.0,5,4,9,PF
1540,1996,Georgia,3,188040,3095047604.0,4,4,8,PF
1541,1996,Germany,52,3241423,2500000000000.0,1,2,3,F
1542,1996,Ghana,2,125464,6934984709.0,3,4,7,PF
1543,1996,Greece,20,1265724,146000000000.0,1,3,4,F
1544,1996,Guatemala,26,1616069,15674835615.0,3,4,7,PF
1545,1996,Guinea,1,62470,3868968302.0,6,5,11,NF
1546,1996,Haiti,27,1694230,2907514523.0,4,5,9,PF
1547,1996,Honduras,19,1208194,5215028986.0,3,3,6,PF
1548,1996,Hungary,13,827826,46658755152.0,1,2,3,F
1549,1996,India,213,13371453,393000000000.0,2,4,6,PF
1550,1996,Indonesia,65,4116004,227000000000.0,7,5,12,NF
1551,1996,Iran,3,188441,120000000000.0,6,7,13,NF
1552,1996,Iraq,12,750289,10433698621.0,7,7,14,NF
1553,1996,Ireland,1,61810,75790786290.0,1,1,2,F
1554,1996,Israel,18,1125086,110000000000.0,1,3,4,F
1555,1996,Italy,8,503222,1310000000000.0,1,2,3,F
1556,1996,Jamaica,1,63550,7393883555.0,2,3,5,F
1557,1996,Japan,8,502952,4920000000000.0,1,2,3,F
1558,1996,Jordan,2,125197,6928359238.0,4,4,8,PF
1559,1996,Kenya,3,190578,12045858436.0,7,6,13,NF
1560,1996,Kyrgyzstan,5,313583,1827570586.0,4,4,8,PF
1561,1996,Lebanon,39,2450310,13690217333.0,6,5,11,NF
1563,1996,Libya,4,251231,27884615385.0,7,7,14,NF
1564,1996,Lithuania,3,188383,8382519637.0,1,2,3,F
1565,1996,Madagascar,2,127492,4931861239.0,2,4,6,PF
1566,1996,Mauritania,1,63067,2132081882.0,6,6,12,NF
1567,1996,Mexico,75,4724721,411000000000.0,4,3,7,PF
1568,1996,Moldova,2,122889,1695122174.0,3,4,7,PF
1569,1996,Morocco,2,124536,43161452678.0,5,5,10,PF
1570,1996,Myanmar,13,819255,119000000000.0,7,7,14,NF
1571,1996,Nepal,5,317119,4521580381.0,3,4,7,PF
1572,1996,Netherlands,6,369599,450000000000.0,1,1,2,F
1573,1996,New Zealand,2,127989,70140835299.0,1,1,2,F
1574,1996,Nicaragua,26,1620405,4308351903.0,3,3,6,PF
1575,1996,Niger,1,62588,2405687081.0,7,5,12,NF
1576,1996,Nigeria,11,688766,51075815093.0,7,6,13,NF
1577,1996,Norway,1,61847,164000000000.0,1,1,2,F
1578,1996,Pakistan,180,11197320,63320122807.0,4,5,9,PF
1579,1996,Panama,2,126745,9870494000.0,2,3,5,F
1580,1996,Papua New Guinea,10,624421,5155311077.0,2,4,6,PF
1581,1996,Peru,42,2633124,55252414130.0,4,3,7,PF
1582,1996,Philippines,61,3815354,94648084429.0,2,3,5,F
1583,1996,Poland,6,376108,160000000000.0,1,2,3,F
1584,1996,Qatar,1,63577,9059340385.0,7,6,13,NF
1585,1996,Russia,66,4137589,392000000000.0,3,4,7,PF
1586,1996,Rwanda,15,935805,1382334879.0,7,6,13,NF
1587,1996,Saudi Arabia,1,62721,159000000000.0,7,7,14,NF
1588,1996,Sierra Leone,5,310299,941742152.7,4,5,9,PF
1589,1996,Slovenia,3,191091,21507232649.0,1,2,3,F
1591,1996,South Africa,47,2975728,163000000000.0,1,2,3,F
1592,1996,South Korea,1,63095,610000000000.0,2,2,4,F
1593,1996,Spain,63,3957610,643000000000.0,1,2,3,F
1594,1996,Sri Lanka,176,11040004,13897738375.0,3,5,8,PF
1595,1996,Sudan,10,631219,9018243044.0,7,7,14,NF
1596,1996,Sweden,1,64226,292000000000.0,1,1,2,F
1597,1996,Switzerland,4,253650,340000000000.0,1,1,2,F
1598,1996,Syria,2,126637,61546280624.0,7,7,14,NF
1599,1996,Tajikistan,22,1386456,1043654822.0,7,7,14,NF
1600,1996,Thailand,19,1203603,183000000000.0,3,3,6,PF
1601,1996,Togo,1,63678,1465448290.0,6,5,11,NF
1602,1996,Trinidad and Tobago,3,187524,5759537726.0,1,2,3,F
1603,1996,Turkey,54,3393242,181000000000.0,4,5,9,PF
1604,1996,Uganda,29,1816503,6044585327.0,4,4,8,PF
1605,1996,Ukraine,3,187979,44558075977.0,3,4,7,PF
1606,1996,United Kingdom,36,2267072,1420000000000.0,1,2,3,F
1607,1996,United States,35,2200350,8070000000000.0,1,1,2,F
1608,1996,Uruguay,1,62793,20515543039.0,1,2,3,F
1609,1996,Vanuatu,2,127561,261370044.5,1,3,4,F
1610,1996,Vietnam,1,62983,24657470575.0,7,7,14,NF
1611,1996,Zambia,4,251371,3597220962.0,5,4,9,PF
1613,1997,Albania,41,2708499,2258513974.0,4,4,8,PF
1614,1997,Algeria,344,22768228,48177612042.0,6,6,12,NF
1615,1997,Angola,7,458442,7649716157.0,6,6,12,NF
1616,1997,Argentina,11,726495,293000000000.0,2,3,5,F
1617,1997,Australia,4,262640,435000000000.0,1,1,2,F
1618,1997,Austria,1,64364,213000000000.0,1,1,2,F
1619,1997,Azerbaijan,1,64762,3962238113.0,6,4,10,PF
1620,1997,Bahamas,2,130865,6332360000.0,1,2,3,F
1621,1997,Bahrain,11,726371,6349202394.0,7,6,13,NF
1622,1997,Bangladesh,17,1120463,48244309133.0,2,4,6,PF
1623,1997,Belarus,2,133361,14108846154.0,6,6,12,NF
1624,1997,Belgium,2,130657,253000000000.0,1,2,3,F
1625,1997,Bolivia,4,261184,7925673448.0,1,3,4,F
1626,1997,Bosnia-Herzegovina,42,2774270,3671816504.0,5,5,10,PF
1627,1997,Brazil,39,2590214,883000000000.0,3,4,7,PF
1628,1997,Bulgaria,3,196676,11315986087.0,2,3,5,F
1629,1997,Burundi,79,5250685,972896267.9,7,7,14,NF
1630,1997,Cambodia,18,1178613,3443413389.0,7,6,13,NF
1631,1997,Canada,2,134284,655000000000.0,1,1,2,F
1632,1997,Chad,1,66083,1544689503.0,6,5,11,NF
1633,1997,Chile,6,396496,84952360922.0,2,2,4,F
1634,1997,China,18,1174687,962000000000.0,7,7,14,NF
1635,1997,Colombia,598,39537266,107000000000.0,4,4,8,PF
1636,1997,Comoros,3,197608,364445589.7,5,4,9,PF
1637,1997,Costa Rica,1,67105,12614602382.0,1,2,3,F
1638,1997,Croatia,8,532268,24091170703.0,4,4,8,PF
1639,1997,Cuba,14,924505,25365908100.0,7,7,14,NF
1640,1997,Czech Republic,4,266068,62180159376.0,1,2,3,F
1641,1997,Djibouti,1,66492,502675542.0,5,6,11,NF
1642,1997,Dominican Republic,12,788667,20017480055.0,3,3,6,PF
1643,1997,Ecuador,4,263735,28162053027.0,3,3,6,PF
1644,1997,Egypt,22,1453021,78436578171.0,6,6,12,NF
1645,1997,El Salvador,2,133251,10221705900.0,2,3,5,F
1646,1997,Ethiopia,6,391532,8589211390.0,4,5,9,PF
1647,1997,France,130,8435507,1450000000000.0,1,2,3,F
1648,1997,Gabon,1,66414,5326816859.0,5,4,9,PF
1649,1997,Georgia,6,395313,3510520231.0,3,4,7,PF
1650,1997,Germany,12,791081,2210000000000.0,1,2,3,F
1651,1997,Ghana,1,67278,6891308594.0,3,3,6,PF
1652,1997,Greece,21,1390276,143000000000.0,1,3,4,F
1653,1997,Guatemala,26,1718911,17790026222.0,3,4,7,PF
1654,1997,Guyana,1,67417,749138009.6,2,2,4,F
1655,1997,Haiti,16,1047211,3338938830.0,4,5,9,PF
1656,1997,Honduras,22,1436729,5737099650.0,2,3,5,F
1657,1997,Hungary,17,1106511,47296952929.0,1,2,3,F
1658,1997,India,193,12726903,416000000000.0,2,4,6,PF
1659,1997,Indonesia,27,1769342,216000000000.0,7,5,12,NF
1660,1997,Iraq,21,1389001,20764857056.0,7,7,14,NF
1661,1997,Ireland,4,264514,82856648758.0,1,1,2,F
1662,1997,Israel,12,790336,115000000000.0,1,3,4,F
1663,1997,Italy,8,528019,1240000000000.0,1,2,3,F
1664,1997,Jamaica,8,531774,8400033894.0,2,3,5,F
1665,1997,Japan,5,328569,4490000000000.0,1,2,3,F
1666,1997,Jordan,3,198666,7246188575.0,4,4,8,PF
1667,1997,Kazakhstan,2,131700,22165932063.0,6,5,11,NF
1668,1997,Kenya,17,1135333,13115773738.0,6,6,12,NF
1669,1997,Kuwait,2,131775,30355093966.0,5,5,10,PF
1670,1997,Latvia,2,130948,6527926446.0,1,2,3,F
1671,1997,Lebanon,46,3024914,15751867489.0,6,5,11,NF
1672,1997,Lithuania,1,65303,10118631852.0,1,2,3,F
1673,1997,Madagascar,1,65194,4262965282.0,2,4,6,PF
1674,1997,Mali,3,195546,2697102922.0,3,3,6,F
1675,1997,Malta,1,65561,3793418418.0,1,1,2,F
1676,1997,Mexico,95,6283498,500000000000.0,3,4,7,PF
1677,1997,Moldova,1,65802,1930081169.0,3,4,7,PF
1678,1997,Myanmar,35,2274718,155000000000.0,7,7,14,NF
1679,1997,Nepal,9,586454,4918691917.0,3,4,7,PF
1680,1997,Netherlands,1,65070,417000000000.0,1,1,2,F
1681,1997,New Zealand,1,64831,66075143415.0,1,1,2,F
1682,1997,Nicaragua,7,460705,4389965591.0,3,3,6,PF
1683,1997,Niger,3,200213,2290318800.0,7,5,12,NF
1684,1997,Nigeria,20,1318544,54457835193.0,7,6,13,NF
1685,1997,Pakistan,206,13529458,62433300338.0,4,5,9,PF
1686,1997,Panama,6,398128,10677286100.0,2,3,5,F
1687,1997,Papua New Guinea,2,131017,4936615299.0,2,4,6,PF
1688,1997,Paraguay,6,397834,9965225678.0,4,3,7,PF
1689,1997,Peru,58,3818338,58147522523.0,5,4,9,PF
1690,1997,Philippines,57,3744017,94106183450.0,2,3,5,F
1691,1997,Poland,3,196202,159000000000.0,1,2,3,F
1692,1997,Russia,77,5072380,405000000000.0,3,4,7,PF
1693,1997,Rwanda,33,2173773,1851558302.0,7,6,13,NF
1694,1997,Senegal,26,1737604,6041478436.0,4,4,8,PF
1695,1997,Sierra Leone,3,199470,850218033.6,7,6,13,NF
1696,1997,Slovenia,1,66786,20763101741.0,1,2,3,F
1698,1997,South Africa,17,1117378,169000000000.0,1,2,3,F
1699,1997,Spain,86,5655198,590000000000.0,1,2,3,F
1700,1997,Sri Lanka,64,4191636,15091913884.0,3,4,7,PF
1701,1997,Sudan,3,199520,11681494637.0,7,7,14,NF
1702,1997,Suriname,2,132455,926422500.0,3,3,6,PF
1703,1997,Sweden,4,262985,268000000000.0,1,1,2,F
1704,1997,Switzerland,1,66471,295000000000.0,1,1,2,F
1705,1997,Syria,1,65477,66420400891.0,7,7,14,NF
1706,1997,Tajikistan,40,2633589,921572114.5,6,6,12,NF
1707,1997,Tanzania,1,64785,7683852497.0,5,5,10,PF
1708,1997,Thailand,20,1319695,150000000000.0,3,3,6,PF
1709,1997,Turkey,44,2907595,190000000000.0,4,5,9,PF
1710,1997,Uganda,24,1585042,6269333313.0,4,4,8,PF
1711,1997,Ukraine,2,131631,50150400172.0,3,4,7,PF
1712,1997,United Kingdom,78,5119848,1560000000000.0,1,2,3,F
1713,1997,United States,42,2739127,8580000000000.0,1,1,2,F
1714,1997,Uruguay,2,129618,23969823010.0,1,2,3,F
1715,1997,Vietnam,2,130573,26843700442.0,7,7,14,NF
1717,1998,Albania,7,475184,2545964541.0,4,5,9,PF
1718,1998,Algeria,151,10251012,48187747529.0,6,5,11,NF
1719,1998,Angola,20,1363082,6506619145.0,6,6,12,NF
1720,1998,Armenia,2,135949,1893726437.0,4,4,8,PF
1721,1998,Australia,6,410141,399000000000.0,1,1,2,F
1722,1998,Austria,1,67513,218000000000.0,1,1,2,F
1723,1998,Bangladesh,2,136215,49984559471.0,2,4,6,PF
1724,1998,Belgium,3,204850,259000000000.0,1,2,3,F
1725,1998,Bosnia-Herzegovina,9,612502,4116699437.0,5,5,10,PF
1726,1998,Brazil,2,136807,864000000000.0,3,4,7,PF
1727,1998,Bulgaria,2,135389,15030695297.0,2,3,5,F
1728,1998,Burundi,13,883004,893770806.1,7,6,13,NF
1729,1998,Cambodia,7,475490,3120425503.0,6,6,12,NF
1730,1998,Cameroon,1,67758,11298144512.0,7,5,12,NF
1731,1998,Canada,4,272588,634000000000.0,1,1,2,F
1732,1998,Chad,1,67593,1744794457.0,6,4,10,NF
1733,1998,Chile,1,67710,81577430181.0,3,2,5,F
1734,1998,China,2,135454,1030000000000.0,7,6,13,NF
1735,1998,Colombia,94,6392432,98443739941.0,3,4,7,PF
1736,1998,Cyprus,1,68366,10248617647.0,1,1,2,F
1737,1998,Ecuador,3,204770,27981896948.0,2,3,5,F
1738,1998,Egypt,3,203841,84828807556.0,6,6,12,NF
1739,1998,France,12,818145,1500000000000.0,1,2,3,F
1740,1998,Georgia,12,815338,3613541517.0,3,4,7,PF
1741,1998,Germany,6,408992,2240000000000.0,1,2,3,F
1742,1998,Greece,28,1899521,144000000000.0,1,3,4,F
1743,1998,Guyana,2,135032,717530683.2,2,2,4,F
1744,1998,Haiti,1,68192,3723909227.0,5,5,10,PF
1745,1998,Hungary,2,135598,48706787306.0,1,2,3,F
1746,1998,India,61,4147139,421000000000.0,2,3,5,F
1747,1998,Indonesia,3,204358,95445547873.0,6,4,10,PF
1748,1998,Iran,5,339877,110000000000.0,6,6,12,NF
1749,1998,Iraq,7,476558,20617405044.0,7,7,14,NF
1750,1998,Ireland,3,203502,90199410116.0,1,1,2,F
1751,1998,Israel,12,816000,116000000000.0,1,3,4,F
1752,1998,Italy,6,408659,1270000000000.0,1,2,3,F
1753,1998,Japan,1,67590,4100000000000.0,1,2,3,F
1754,1998,Jordan,1,67617,7912327362.0,4,5,9,PF
1755,1998,Kenya,2,135925,14093998844.0,6,5,11,NF
1756,1998,Latvia,4,271995,7166275468.0,1,2,3,F
1757,1998,Lebanon,23,1564787,17247179006.0,6,5,11,NF
1758,1998,Mexico,2,135869,527000000000.0,3,4,7,PF
1759,1998,Nigeria,2,135593,54604050168.0,6,4,10,PF
1760,1998,Pakistan,37,2512696,62191955814.0,4,5,9,PF
1761,1998,Peru,5,339249,55501467877.0,5,4,9,PF
1762,1998,Philippines,18,1224711,74492325247.0,2,3,5,F
1763,1998,Poland,2,136183,175000000000.0,1,2,3,F
1764,1998,Russia,26,1767840,271000000000.0,4,4,8,PF
1765,1998,Rwanda,9,610774,1989343495.0,7,6,13,NF
1766,1998,Senegal,1,68253,6505607633.0,4,4,8,PF
1767,1998,Sierra Leone,7,477301,672375927.3,3,5,8,PF
1769,1998,South Africa,6,409025,153000000000.0,1,2,3,F
1770,1998,Spain,17,1152947,619000000000.0,1,2,3,F
1771,1998,Sri Lanka,35,2373524,15794972847.0,3,4,7,PF
1772,1998,Switzerland,1,68256,304000000000.0,1,1,2,F
1773,1998,Syria,1,68239,70418173719.0,7,7,14,NF
1774,1998,Tajikistan,11,750044,1320242081.0,6,6,12,NF
1775,1998,Tanzania,1,68071,12270448700.0,5,4,9,PF
1776,1998,Thailand,4,270752,114000000000.0,2,3,5,F
1777,1998,Turkey,23,1568333,276000000000.0,4,5,9,PF
1778,1998,Uganda,18,1223577,6584815847.0,4,4,8,PF
1779,1998,United Kingdom,63,4274161,1650000000000.0,1,2,3,F
1780,1998,United States,31,2107783,9060000000000.0,1,1,2,F
1782,1999,Albania,3,207483,3212121651.0,4,5,9,PF
1783,1999,Algeria,106,7324652,48640653469.0,6,5,11,NF
1784,1999,Angola,34,2344770,6152936539.0,6,6,12,NF
1785,1999,Argentina,1,68803,284000000000.0,2,3,5,F
1786,1999,Armenia,2,139358,1845482173.0,4,4,8,PF
1787,1999,Bangladesh,11,759609,51270569884.0,3,4,7,PF
1788,1999,Belarus,1,68789,12152867470.0,6,6,12,NF
1789,1999,Belgium,2,138491,258000000000.0,1,2,3,F
1790,1999,Bosnia-Herzegovina,5,344132,4685733115.0,5,5,10,PF
1791,1999,Brazil,1,68905,600000000000.0,3,4,7,PF
1792,1999,Bulgaria,1,69689,13627323285.0,2,3,5,F
1793,1999,Burundi,13,903321,808077223.4,6,6,12,NF
1794,1999,Cambodia,8,551651,3517242477.0,6,6,12,NF
1795,1999,Canada,2,138633,678000000000.0,1,1,2,F
1796,1999,Chad,1,69180,1534673583.0,6,5,11,NF
1797,1999,Chile,3,208665,75173794497.0,2,2,4,F
1798,1999,China,2,137894,1090000000000.0,7,6,13,NF
1799,1999,Colombia,116,8020733,86186158685.0,4,4,8,PF
1800,1999,Cyprus,1,69323,10497908306.0,1,1,2,F
1801,1999,Denmark,1,69426,178000000000.0,1,1,2,F
1802,1999,Ecuador,2,138801,19645272636.0,2,3,5,F
1803,1999,Egypt,1,69401,90710704807.0,6,5,11,NF
1804,1999,Estonia,1,68990,5756912266.0,1,2,3,F
1805,1999,Ethiopia,2,139056,7700833482.0,5,5,10,PF
1806,1999,Fiji,3,208032,1936484565.0,2,3,5,F
1807,1999,France,46,3186409,1490000000000.0,1,2,3,F
1808,1999,Georgia,7,484093,2800049395.0,3,4,7,PF
1809,1999,Germany,13,895223,2190000000000.0,1,2,3,F
1810,1999,Greece,35,2417848,143000000000.0,1,3,4,F
1811,1999,Guatemala,1,69641,18318412251.0,3,4,7,PF
1812,1999,Haiti,5,345788,4153736347.0,5,5,10,PF
1813,1999,India,112,7758375,459000000000.0,2,3,5,F
1814,1999,Indonesia,60,4153245,140000000000.0,4,4,8,PF
1815,1999,Iran,8,553471,114000000000.0,6,6,12,NF
1816,1999,Iraq,12,826960,36881601584.0,7,7,14,NF
1817,1999,Ireland,3,206821,98860565736.0,1,1,2,F
1818,1999,Israel,8,554921,117000000000.0,1,2,3,F
1819,1999,Italy,7,484968,1250000000000.0,1,2,3,F
1820,1999,Japan,2,138501,4640000000000.0,1,2,3,F
1821,1999,Jordan,2,139365,8149106065.0,4,4,8,PF
1823,1999,Kyrgyzstan,3,208224,1249061487.0,5,5,10,PF
1824,1999,Latvia,1,68775,7533788134.0,1,2,3,F
1825,1999,Lebanon,42,2905243,17391056369.0,6,5,11,NF
1827,1999,Mexico,1,69439,600000000000.0,3,4,7,PF
1828,1999,Mozambique,1,68995,5976408044.0,3,4,7,PF
1829,1999,Myanmar,4,277385,303000000000.0,7,7,14,NF
1830,1999,Namibia,1,69276,3868541599.0,2,3,5,F
1831,1999,Nepal,8,553221,5033642384.0,3,4,7,PF
1832,1999,Netherlands,1,68533,447000000000.0,1,1,2,F
1833,1999,Nicaragua,1,69462,4855717875.0,3,3,6,PF
1834,1999,Niger,2,138287,2537790023.0,5,5,10,PF
1835,1999,Nigeria,18,1248030,59372613486.0,4,3,7,PF
1836,1999,Pakistan,39,2702835,62973855719.0,7,5,12,NF
1837,1999,Panama,1,68729,12130252200.0,1,2,3,F
1838,1999,Paraguay,1,68704,8837070236.0,4,3,7,PF
1839,1999,Peru,5,345480,50187324568.0,5,4,9,PF
1840,1999,Philippines,31,2140640,85640133800.0,2,3,5,F
1841,1999,Russia,54,3730339,196000000000.0,4,5,9,PF
1842,1999,Senegal,1,68833,6592835458.0,4,4,8,PF
1843,1999,Sierra Leone,9,621083,669384768.9,3,5,8,PF
1844,1999,Solomon Islands,1,69006,488001488.2,1,2,3,F
1846,1999,South Africa,17,1172686,152000000000.0,1,2,3,F
1847,1999,Spain,47,3249947,635000000000.0,1,2,3,F
1848,1999,Sri Lanka,46,3179658,15656327860.0,3,4,7,PF
1849,1999,Sudan,5,344838,10682045258.0,7,7,14,NF
1850,1999,Sweden,2,138208,274000000000.0,1,1,2,F
1851,1999,Switzerland,2,137076,299000000000.0,1,1,2,F
1852,1999,Tajikistan,4,277578,1086605267.0,6,6,12,NF
1853,1999,Thailand,4,276446,127000000000.0,2,3,5,F
1854,1999,Turkey,109,7524870,256000000000.0,4,5,9,PF
1855,1999,Uganda,19,1310806,5998563258.0,5,5,10,PF
1856,1999,Ukraine,6,417379,31580960682.0,3,4,7,PF
1857,1999,United Kingdom,76,5240700,1690000000000.0,1,2,3,F
1858,1999,United States,53,3669088,9630000000000.0,1,1,2,F
1859,1999,Uzbekistan,8,549408,17078465982.0,7,6,13,NF
1860,1999,Zambia,7,480797,3404311977.0,5,4,9,PF
1862,2000,Albania,2,142647,3480355258.0,4,5,9,PF
1863,2000,Algeria,138,9765428,54790392746.0,6,5,11,NF
1864,2000,Angola,22,1555580,9129634978.0,6,6,12,NF
1865,2000,Armenia,2,140783,1911563669.0,4,4,8,PF
1866,2000,Australia,1,71216,416000000000.0,1,1,2,F
1867,2000,Azerbaijan,1,70208,5272798391.0,6,5,11,PF
1868,2000,Bangladesh,23,1611899,53369787319.0,3,4,7,PF
1869,2000,Belize,1,70130,832072450.0,1,1,2,F
1870,2000,Bosnia-Herzegovina,6,421605,5567405599.0,5,4,9,PF
1871,2000,Brazil,2,141173,655000000000.0,3,3,6,PF
1872,2000,Bulgaria,2,142772,13245833844.0,2,3,5,F
1873,2000,Burundi,17,1204413,870486065.9,6,6,12,NF
1874,2000,Cambodia,4,285147,3654031716.0,6,6,12,NF
1875,2000,Canada,5,354775,745000000000.0,1,1,2,F
1876,2000,Central African Republic,1,70907,914500299.1,3,4,7,PF
1877,2000,Chile,2,142985,77860932152.0,2,2,4,F
1878,2000,China,4,283979,1210000000000.0,7,6,13,NF
1879,2000,Colombia,137,9682428,99886577331.0,4,4,8,PF
1880,2000,Croatia,2,141335,21839780971.0,2,3,5,F
1881,2000,Cyprus,2,141596,9985844486.0,1,1,2,F
1882,2000,Ecuador,4,281294,18327764882.0,3,3,6,PF
1883,2000,Ethiopia,1,70904,8242392104.0,5,5,10,PF
1884,2000,Fiji,4,283907,1678239218.0,6,3,9,PF
1885,2000,France,28,1982030,1360000000000.0,1,2,3,F
1886,2000,Georgia,7,495996,3057475335.0,4,4,8,PF
1887,2000,Germany,8,565470,1940000000000.0,1,2,3,F
1888,2000,Greece,28,1979800,130000000000.0,1,3,4,F
1889,2000,Guatemala,1,70745,19288827159.0,3,4,7,PF
1890,2000,Guinea,12,855825,2995361141.0,6,5,11,NF
1891,2000,Haiti,9,638385,6813577558.0,6,5,11,NF
1892,2000,India,180,12722381,468000000000.0,2,3,5,F
1893,2000,Indonesia,101,7190683,165000000000.0,3,4,7,PF
1894,2000,Iran,15,1059872,110000000000.0,6,6,12,NF
1895,2000,Iraq,10,704388,48364250944.0,7,7,14,NF
1896,2000,Israel,13,923026,132000000000.0,1,3,4,F
1897,2000,Italy,8,566609,1140000000000.0,1,2,3,F
1898,2000,Japan,13,916724,4970000000000.0,1,2,3,F
1899,2000,Jordan,2,142914,8460424401.0,4,4,8,PF
1900,2000,Kazakhstan,1,71085,18291994909.0,6,5,11,NF
1901,2000,Kenya,4,283911,12705357103.0,6,5,11,NF
1903,2000,Kyrgyzstan,4,283198,1369688498.0,6,5,11,NF
1904,2000,Latvia,3,212846,7958852839.0,1,2,3,F
1905,2000,Lebanon,12,842071,17260364842.0,6,5,11,NF
1906,2000,Liberia,1,71481,874000000.0,5,6,11,PF
1907,2000,Malaysia,3,211664,93789736842.0,5,5,10,PF
1908,2000,Mexico,4,283109,708000000000.0,2,3,5,F
1909,2000,Moldova,1,71319,1288429392.0,2,4,6,PF
1910,2000,Mozambique,3,212798,5656473652.0,3,4,7,PF
1911,2000,Namibia,21,1478514,3922247990.0,2,3,5,F
1912,2000,Nepal,23,1625560,5494252208.0,3,4,7,PF
1913,2000,Netherlands,1,70566,416000000000.0,1,1,2,F
1914,2000,Nicaragua,1,70191,5107329007.0,3,3,6,PF
1915,2000,Nigeria,6,421992,69448756933.0,4,4,8,PF
1916,2000,Pakistan,49,3468523,82017743416.0,6,5,11,NF
1917,2000,Panama,1,71418,12304115000.0,1,2,3,F
1918,2000,Paraguay,2,140369,8855705140.0,4,3,7,PF
1919,2000,Peru,3,211420,51744749133.0,3,4,7,PF
1920,2000,Philippines,132,9340286,83669693589.0,2,3,5,F
1921,2000,Qatar,1,71020,17759890110.0,6,6,12,NF
1922,2000,Russia,138,9777348,260000000000.0,5,5,10,PF
1923,2000,Rwanda,1,70430,2067528500.0,7,6,13,NF
1924,2000,Saudi Arabia,5,356393,190000000000.0,7,7,14,NF
1925,2000,Senegal,4,282821,6013184809.0,3,4,7,PF
1926,2000,Sierra Leone,24,1695752,635874002.2,4,5,9,PF
1927,2000,Slovenia,1,71411,20289627637.0,1,2,3,F
1928,2000,Solomon Islands,1,71035,419933580.9,4,4,8,PF
1930,2000,South Africa,21,1487199,152000000000.0,1,2,3,F
1931,2000,Spain,112,7922913,597000000000.0,1,2,3,F
1932,2000,Sri Lanka,68,4800703,16330814180.0,3,4,7,PF
1933,2000,St. Lucia,1,71653,932592592.6,1,2,3,F
1934,2000,Sudan,7,493096,12257418326.0,7,7,14,NF
1935,2000,Sweden,1,71397,263000000000.0,1,1,2,F
1936,2000,Switzerland,4,281997,280000000000.0,1,1,2,F
1937,2000,Tajikistan,6,423833,860521119.3,6,6,12,NF
1938,2000,Tanzania,2,142769,13375976354.0,4,4,8,PF
1939,2000,Thailand,4,282128,126000000000.0,2,3,5,F
1940,2000,Tunisia,1,70398,21473261837.0,6,5,11,NF
1941,2000,Turkey,35,2474785,274000000000.0,4,5,9,PF
1942,2000,Uganda,20,1410882,6193246837.0,6,5,11,PF
1943,2000,Ukraine,1,71342,32375280321.0,4,4,8,PF
1944,2000,United Kingdom,61,4321591,1660000000000.0,1,2,3,F
1945,2000,United States,42,2963927,10300000000000.0,1,1,2,F
1946,2000,Zambia,8,559388,3600683040.0,5,4,9,PF
1947,2000,Zimbabwe,1,70606,6689957600.0,6,5,11,PF
1949,2001,Albania,1,72227,3922100794.0,3,4,7,PF
1950,2001,Algeria,113,8200006,54744712815.0,6,5,11,NF
1951,2001,Angola,40,2902742,8936063723.0,6,6,12,NF
1952,2001,Argentina,2,143830,269000000000.0,3,3,6,PF
1953,2001,Armenia,2,145544,2118467913.0,4,4,8,PF
1954,2001,Australia,2,146451,379000000000.0,1,1,2,F
1955,2001,Azerbaijan,4,291838,5707720391.0,6,5,11,PF
1956,2001,Bangladesh,15,1085943,53991289844.0,3,4,7,PF
1957,2001,Belarus,1,72333,12354820144.0,6,6,12,NF
1958,2001,Bosnia-Herzegovina,2,144414,5800774717.0,5,4,9,PF
1959,2001,Brazil,3,219268,560000000000.0,3,3,6,PF
1960,2001,Bulgaria,1,72026,14183497963.0,1,3,4,F
1961,2001,Burundi,37,2691586,876794723.1,6,6,12,NF
1962,2001,Cambodia,7,510785,3984000517.0,6,5,11,NF
1963,2001,Central African Republic,1,72311,931833302.8,5,5,10,PF
1964,2001,Chile,3,219616,70979923960.0,2,2,4,F
1965,2001,China,12,879254,1340000000000.0,7,6,13,NF
1966,2001,Colombia,207,15047725,98211749596.0,4,4,8,PF
1967,2001,Costa Rica,1,72436,15976174337.0,1,2,3,F
1968,2001,Croatia,3,216210,23273640257.0,2,2,4,F
1969,2001,Cyprus,1,72302,10397897086.0,1,1,2,F
1970,2001,Czech Republic,1,72637,67808032980.0,1,2,3,F
1971,2001,Ecuador,5,362047,24468324000.0,3,3,6,PF
1972,2001,Estonia,1,72018,6254649539.0,1,2,3,F
1973,2001,Fiji,1,73198,1652464201.0,4,3,7,PF
1974,2001,France,21,1529324,1380000000000.0,1,2,3,F
1975,2001,Georgia,4,290468,3219488664.0,4,4,8,PF
1976,2001,Germany,8,579792,1940000000000.0,1,2,3,F
1977,2001,Greece,14,1011220,136000000000.0,1,3,4,F
1978,2001,Guatemala,2,143855,18405203853.0,3,4,7,PF
1979,2001,Guinea-Bissau,1,71943,392621385.9,4,5,9,PF
1980,2001,Guyana,1,72217,712167575.6,2,2,4,F
1981,2001,Haiti,5,359030,6331961555.0,6,6,12,NF
1982,2001,Hungary,1,72389,53749989092.0,1,2,3,F
1983,2001,India,234,17000646,485000000000.0,2,3,5,F
1984,2001,Indonesia,106,7707521,160000000000.0,3,4,7,PF
1985,2001,Iran,4,288195,127000000000.0,6,6,12,NF
1986,2001,Iraq,3,216643,36176430129.0,7,7,14,NF
1987,2001,Ireland,2,144182,109000000000.0,1,1,2,F
1988,2001,Israel,70,5089703,131000000000.0,1,3,4,F
1989,2001,Italy,11,799308,1170000000000.0,1,2,3,F
1990,2001,Japan,3,217582,4370000000000.0,1,2,3,F
1991,2001,Jordan,2,145699,8975689845.0,5,5,10,PF
1992,2001,Kazakhstan,1,71916,22152694162.0,6,5,11,NF
1993,2001,Kenya,7,509778,12986007426.0,6,5,11,NF
1995,2001,Kuwait,2,145312,34887512227.0,4,5,9,PF
1996,2001,Kyrgyzstan,1,72514,1525116370.0,6,5,11,NF
1997,2001,Lebanon,5,363395,17649751244.0,6,5,11,NF
1998,2001,Liberia,3,218140,906000000.0,6,6,12,NF
1999,2001,Malaysia,1,71837,92783947368.0,5,5,10,PF
2000,2001,Mexico,7,508853,757000000000.0,2,3,5,F
2002,2001,Myanmar,3,218320,453000000000.0,7,7,14,NF
2003,2001,Namibia,6,437698,3557333364.0,2,3,5,F
2004,2001,Nepal,33,2402305,6007055042.0,3,4,7,PF
2005,2001,Netherlands,1,71745,431000000000.0,1,1,2,F
2006,2001,New Zealand,1,73449,53872425917.0,1,1,2,F
2007,2001,Nigeria,5,364666,74030364472.0,4,5,9,PF
2008,2001,Norway,1,71798,174000000000.0,1,1,2,F
2009,2001,Pakistan,53,3837996,79484403985.0,6,5,11,NF
2010,2001,Peru,3,217633,52030158775.0,1,3,4,F
2011,2001,Philippines,50,3631681,78921234457.0,2,3,5,F
2012,2001,Poland,1,72819,191000000000.0,1,2,3,F
2013,2001,Qatar,1,73342,17538461538.0,6,6,12,NF
2014,2001,Russia,135,9804606,307000000000.0,5,5,10,PF
2015,2001,Rwanda,2,145257,1965444515.0,7,6,13,NF
2016,2001,Saudi Arabia,3,217523,184000000000.0,7,7,14,NF
2017,2001,Senegal,8,580352,6507824767.0,3,4,7,PF
2019,2001,South Korea,1,71842,548000000000.0,2,2,4,F
2020,2001,Spain,79,5729591,627000000000.0,1,2,3,F
2021,2001,Sri Lanka,36,2624991,15749753805.0,3,4,7,PF
2022,2001,Sudan,9,650764,15716489370.0,7,7,14,NF
2023,2001,Switzerland,2,144872,287000000000.0,1,1,2,F
2024,2001,Tajikistan,6,434240,1080768907.0,6,6,12,NF
2025,2001,Tanzania,4,288583,13581644246.0,4,4,8,PF
2026,2001,Thailand,14,1017209,120000000000.0,2,3,5,F
2027,2001,Tunisia,1,73288,22066031834.0,6,5,11,NF
2028,2001,Turkey,19,1371301,202000000000.0,4,5,9,PF
2029,2001,Uganda,24,1737703,5840503869.0,6,5,11,PF
2030,2001,United Kingdom,94,6808236,1640000000000.0,1,2,3,F
2031,2001,United States,47,3419777,10600000000000.0,1,1,2,F
2032,2001,Vietnam,4,287721,32685198735.0,7,6,13,NF
2033,2001,Zimbabwe,3,216202,6777384700.0,6,6,12,NF
2034,2002,Afghanistan,38,2828085,4055179566.0,6,6,12,NF
2035,2002,Algeria,132,9797679,56760355865.0,6,5,11,NF
2036,2002,Angola,6,442803,15285594828.0,6,5,11,NF
2037,2002,Azerbaijan,1,74071,6235856820.0,6,5,11,PF
2038,2002,Bangladesh,5,372912,54724081491.0,4,4,8,PF
2039,2002,Belgium,3,222759,257000000000.0,1,1,2,F
2040,2002,Bosnia-Herzegovina,3,222761,6728771314.0,4,4,8,PF
2041,2002,Brazil,1,74321,510000000000.0,2,3,5,F
2042,2002,Bulgaria,1,74683,16402846413.0,1,2,3,F
2043,2002,Burundi,18,1336061,825394490.2,6,5,11,NF
2044,2002,Cambodia,3,221072,4284028483.0,6,5,11,NF
2045,2002,Chad,4,297249,1997005787.0,6,5,11,NF
2046,2002,Chile,1,74613,69736811435.0,2,1,3,F
2047,2002,China,2,148818,1470000000000.0,7,6,13,NF
2048,2002,Colombia,150,11120653,97963003805.0,4,4,8,PF
2049,2002,Ecuador,2,149107,28548945000.0,3,3,6,PF
2050,2002,Ethiopia,3,223320,7850809498.0,5,5,10,PF
2051,2002,France,32,2377090,1490000000000.0,1,1,2,F
2052,2002,Georgia,2,148217,3395728014.0,4,4,8,PF
2053,2002,Germany,3,222447,2070000000000.0,1,1,2,F
2054,2002,Greece,11,815240,154000000000.0,1,2,3,F
2055,2002,Guyana,1,74638,726131434.7,2,2,4,F
2056,2002,Haiti,2,148266,6058134467.0,6,6,12,NF
2057,2002,Honduras,1,74179,7775251510.0,3,3,6,PF
2058,2002,India,184,13676104,515000000000.0,2,3,5,F
2059,2002,Indonesia,43,3197719,196000000000.0,3,4,7,PF
2060,2002,Iraq,6,446046,32928454672.0,7,7,14,NF
2061,2002,Israel,72,5340153,121000000000.0,1,3,4,F
2062,2002,Italy,7,521903,1270000000000.0,1,1,2,F
2063,2002,Japan,2,148254,4180000000000.0,1,2,3,F
2064,2002,Jordan,2,148578,9582453032.0,6,5,11,PF
2065,2002,Kenya,2,149675,13147743911.0,4,4,8,PF
2067,2002,Kuwait,1,74678,38137545245.0,4,5,9,PF
2068,2002,Kyrgyzstan,2,148924,1605643105.0,6,5,11,NF
2069,2002,Lebanon,8,594657,19152238806.0,6,5,11,NF
2070,2002,Liberia,3,222447,927000000.0,6,6,12,NF
2071,2002,Madagascar,5,371203,5351701534.0,3,4,7,PF
2072,2002,Malawi,1,74479,3495748398.0,4,4,8,PF
2073,2002,Myanmar,4,296277,683000000000.0,7,7,14,NF
2074,2002,Nepal,58,4312103,6050875807.0,4,4,8,PF
2075,2002,Netherlands,2,148243,472000000000.0,1,1,2,F
2076,2002,Nigeria,6,447146,95385819321.0,4,5,9,PF
2077,2002,Pakistan,46,3415175,79904985385.0,6,5,11,NF
2078,2002,Papua New Guinea,1,74370,2999511040.0,2,3,5,F
2079,2002,Peru,2,148477,54777553515.0,2,3,5,F
2080,2002,Philippines,48,3565374,84307291974.0,2,3,5,F
2081,2002,Russia,89,6600541,345000000000.0,5,5,10,PF
2082,2002,Saudi Arabia,2,149097,190000000000.0,7,7,14,NF
2083,2002,Senegal,3,222503,7006402592.0,2,3,5,F
2084,2002,Solomon Islands,1,74532,346431958.3,3,3,6,PF
2086,2002,South Africa,8,598120,129000000000.0,1,2,3,F
2087,2002,Spain,41,3037742,705000000000.0,1,1,2,F
2088,2002,Sri Lanka,3,223451,16536535647.0,3,4,7,PF
2089,2002,Sudan,13,962860,18136839087.0,7,7,14,NF
2090,2002,Tanzania,2,147343,14142035080.0,4,3,7,PF
2091,2002,Thailand,12,892519,134000000000.0,2,3,5,F
2092,2002,Tunisia,1,73975,23142153760.0,6,5,11,NF
2093,2002,Turkey,5,370730,240000000000.0,3,4,7,PF
2094,2002,Turkmenistan,1,74825,4461978499.0,7,7,14,NF
2095,2002,Uganda,24,1786937,6178563591.0,6,4,10,PF
2096,2002,Ukraine,3,221755,43956369917.0,4,4,8,PF
2097,2002,United Kingdom,21,1557411,1780000000000.0,1,1,2,F
2098,2002,United States,33,2447299,10900000000000.0,1,1,2,F
2099,2002,Zambia,1,73938,4193845678.0,4,4,8,PF
2100,2002,Zimbabwe,8,592199,6342116400.0,6,6,12,NF
2101,2003,Afghanistan,100,7558187,4515558808.0,6,6,12,NF
2102,2003,Albania,1,76139,5611496257.0,3,3,6,PF
2103,2003,Algeria,75,5664286,67863828413.0,6,5,11,NF
2104,2003,Argentina,1,75457,128000000000.0,2,2,4,F
2105,2003,Bahrain,1,75361,11074813830.0,5,5,10,PF
2106,2003,Bangladesh,4,300889,60158929188.0,4,4,8,PF
2107,2003,Belgium,8,605276,317000000000.0,1,1,2,F
2108,2003,Bolivia,1,76175,8082364868.0,3,3,6,PF
2109,2003,Bosnia-Herzegovina,1,75073,8498560902.0,4,4,8,PF
2110,2003,Brazil,1,75446,558000000000.0,2,3,5,F
2111,2003,Burundi,18,1361828,784654423.6,5,5,10,PF
2112,2003,Cambodia,1,75172,4658246918.0,6,5,11,NF
2113,2003,Chile,2,150729,75643459840.0,1,1,2,F
2114,2003,China,3,225406,1660000000000.0,7,6,13,NF
2115,2003,Colombia,98,7388676,94641378693.0,4,4,8,PF
2116,2003,Czech Republic,1,74972,100000000000.0,1,2,3,F
2117,2003,Ecuador,4,301002,32432858000.0,3,3,6,PF
2118,2003,Ethiopia,1,75921,8623691300.0,5,5,10,PF
2119,2003,France,34,2568571,1840000000000.0,1,1,2,F
2120,2003,Georgia,6,454467,3991284895.0,4,4,8,PF
2121,2003,Germany,2,151659,2500000000000.0,1,1,2,F
2122,2003,Greece,12,910173,202000000000.0,1,2,3,F
2123,2003,Guatemala,3,225024,21576351799.0,4,4,8,PF
2124,2003,Guinea-Bissau,1,75147,477458598.7,6,4,10,PF
2125,2003,Guyana,1,75437,743064076.8,2,2,4,F
2126,2003,Haiti,5,379561,4826827577.0,6,6,12,NF
2127,2003,India,196,14792066,608000000000.0,2,3,5,F
2128,2003,Indonesia,18,1358818,235000000000.0,3,4,7,PF
2129,2003,Iran,2,151940,154000000000.0,6,6,12,NF
2130,2003,Iraq,102,7745749,21921569479.0,7,5,12,NF
2131,2003,Ireland,1,75526,164000000000.0,1,1,2,F
2132,2003,Israel,34,2569020,127000000000.0,1,3,4,F
2133,2003,Italy,15,1134962,1570000000000.0,1,1,2,F
2134,2003,Japan,2,150277,4520000000000.0,1,2,3,F
2135,2003,Kenya,2,150001,14904517650.0,3,3,6,PF
2137,2003,Kuwait,3,226576,47876510067.0,4,5,9,PF
2138,2003,Kyrgyzstan,1,75534,1919008090.0,6,5,11,NF
2139,2003,Lebanon,5,378537,20082918740.0,6,5,11,NF
2140,2003,Liberia,2,150812,748000000.0,6,6,12,NF
2141,2003,Mexico,1,74958,729000000000.0,2,2,4,F
2142,2003,Morocco,5,377880,52064058834.0,5,5,10,PF
2143,2003,Myanmar,9,679378,1060000000000.0,7,7,14,NF
2144,2003,Nepal,15,1132590,6330473097.0,5,4,9,PF
2145,2003,Netherlands,3,227288,579000000000.0,1,1,2,F
2146,2003,New Zealand,3,225755,88250885550.0,1,1,2,F
2147,2003,Nigeria,9,680158,105000000000.0,4,4,8,PF
2148,2003,Norway,1,75332,229000000000.0,1,1,2,F
2149,2003,Pakistan,29,2190278,91760542940.0,6,5,11,NF
2150,2003,Peru,1,75751,58731030122.0,2,3,5,F
2151,2003,Philippines,107,8060782,87039145965.0,2,3,5,F
2152,2003,Russia,76,5739506,430000000000.0,5,5,10,PF
2153,2003,Saudi Arabia,8,606455,216000000000.0,7,7,14,NF
2154,2003,Solomon Islands,1,75139,352522682.2,3,3,6,PF
2156,2003,South Korea,1,76045,703000000000.0,2,2,4,F
2157,2003,Spain,21,1591117,905000000000.0,1,1,2,F
2158,2003,Sri Lanka,9,679637,18881765437.0,3,3,6,PF
2159,2003,Switzerland,1,75622,363000000000.0,1,1,2,F
2160,2003,Thailand,6,454291,152000000000.0,2,3,5,F
2161,2003,Turkey,19,1437074,315000000000.0,3,4,7,PF
2162,2003,Uganda,30,2269516,6606884391.0,5,4,9,PF
2163,2003,Ukraine,1,76055,52010238716.0,4,4,8,PF
2164,2003,United Kingdom,23,1735858,2060000000000.0,1,1,2,F
2165,2003,United States,33,2494904,11500000000000.0,1,1,2,F
2166,2003,Zimbabwe,1,75032,5727591800.0,6,6,12,NF
2167,2004,Afghanistan,88,6752308,5226778809.0,5,6,11,NF
2168,2004,Algeria,67,5141899,85332581189.0,6,5,11,NF
2169,2004,Bangladesh,11,843456,65108544250.0,4,4,8,PF
2170,2004,Burundi,1,76223,915257323.4,5,5,10,PF
2171,2004,Canada,2,153597,1030000000000.0,1,1,2,F
2172,2004,China,2,153033,1960000000000.0,7,6,13,NF
2173,2004,Colombia,37,2835047,117000000000.0,4,4,8,PF
2174,2004,Cyprus,1,76952,17320552500.0,1,1,2,F
2175,2004,Djibouti,1,76239,666072101.8,5,5,10,PF
2176,2004,Ecuador,2,152584,36591661000.0,3,3,6,PF
2177,2004,Egypt,3,231297,78782467532.0,6,5,11,NF
2178,2004,Ethiopia,2,152942,10131187261.0,5,5,10,PF
2179,2004,France,11,844610,2120000000000.0,1,1,2,F
2180,2004,Georgia,3,230163,5125365192.0,3,4,7,PF
2181,2004,Germany,3,229230,2810000000000.0,1,1,2,F
2182,2004,Greece,4,306635,241000000000.0,1,2,3,F
2183,2004,Guatemala,2,154119,23577286227.0,4,4,8,PF
2184,2004,Haiti,2,152612,6036959915.0,7,6,13,NF
2185,2004,Honduras,1,77335,8772169959.0,3,3,6,PF
2186,2004,India,108,8282079,709000000000.0,2,3,5,F
2187,2004,Indonesia,17,1305455,257000000000.0,3,4,7,PF
2188,2004,Iraq,323,24820207,36627901762.0,7,5,12,NF
2189,2004,Israel,18,1378339,136000000000.0,1,3,4,F
2190,2004,Italy,3,229229,1800000000000.0,1,1,2,F
2192,2004,Lebanon,1,77074,21159827992.0,6,5,11,NF
2193,2004,Mauritania,1,77083,2362501023.0,6,5,11,NF
2194,2004,Mexico,1,76357,782000000000.0,2,2,4,F
2195,2004,Myanmar,2,154050,1430000000000.0,7,7,14,NF
2196,2004,Nepal,62,4751769,7273938315.0,5,5,10,PF
2197,2004,Netherlands,1,77209,657000000000.0,1,1,2,F
2198,2004,Nigeria,6,458529,136000000000.0,4,4,8,PF
2199,2004,Pakistan,67,5146156,108000000000.0,6,5,11,NF
2200,2004,Peru,3,229895,66768703498.0,2,3,5,F
2201,2004,Philippines,32,2454694,95002028505.0,2,3,5,F
2202,2004,Russia,44,3378817,591000000000.0,6,5,11,NF
2203,2004,Saudi Arabia,17,1305086,259000000000.0,7,7,14,NF
2205,2004,Spain,31,2384299,1070000000000.0,1,1,2,F
2206,2004,Sri Lanka,33,2536391,20662525941.0,3,3,6,PF
2207,2004,Sudan,5,384513,26645490675.0,7,7,14,NF
2208,2004,Syria,1,76481,113000000000.0,7,7,14,NF
2209,2004,Tanzania,1,76378,16675948415.0,4,3,7,PF
2210,2004,Thailand,44,3380003,173000000000.0,2,3,5,F
2211,2004,Turkey,27,2073916,409000000000.0,3,3,6,PF
2212,2004,Uganda,10,765415,7939487474.0,5,4,9,PF
2213,2004,United Kingdom,5,384407,2420000000000.0,1,1,2,F
2214,2004,United States,9,690170,12200000000000.0,1,1,2,F
2215,2004,Uzbekistan,5,383274,12030023548.0,7,6,13,NF
2216,2005,Afghanistan,155,12187640,6209137625.0,5,5,10,PF
2217,2005,Algeria,104,8163125,103000000000.0,6,5,11,NF
2218,2005,Argentina,3,234765,199000000000.0,2,2,4,F
2219,2005,Bangladesh,23,1813648,69442943089.0,4,4,8,PF
2220,2005,Bolivia,1,78104,9549077869.0,3,3,6,PF
2221,2005,Bosnia-Herzegovina,1,77352,11222953335.0,4,3,7,PF
2222,2005,Burundi,5,390707,1117113046.0,3,5,8,PF
2223,2005,China,1,77479,2290000000000.0,7,6,13,NF
2224,2005,Colombia,42,3303594,146000000000.0,3,3,6,PF
2225,2005,Croatia,1,78981,45780237257.0,2,2,4,F
2226,2005,Egypt,2,156578,89600665557.0,6,5,11,NF
2227,2005,Ethiopia,5,393784,12401139454.0,5,5,10,PF
2228,2005,France,33,2576237,2200000000000.0,1,1,2,F
2229,2005,Georgia,6,468743,6410823633.0,3,3,6,PF
2230,2005,Germany,3,234750,2850000000000.0,1,1,2,F
2231,2005,Greece,6,471712,248000000000.0,1,2,3,F
2232,2005,Guinea,1,77471,2937071767.0,6,5,11,NF
2233,2005,Guinea-Bissau,4,314183,587029054.4,3,4,7,PF
2234,2005,Haiti,1,79106,7184064657.0,7,6,13,NF
2235,2005,India,146,11443053,820000000000.0,2,3,5,F
2236,2005,Indonesia,15,1174648,286000000000.0,2,3,5,F
2237,2005,Iran,5,393412,226000000000.0,6,6,12,NF
2238,2005,Iraq,617,48281641,49954890353.0,6,5,11,NF
2239,2005,Israel,28,2192089,143000000000.0,1,2,3,F
2240,2005,Italy,6,468201,1860000000000.0,1,1,2,F
2241,2005,Jordan,4,316390,12588665303.0,5,4,9,PF
2242,2005,Kenya,2,157004,18737897745.0,3,3,6,PF
2244,2005,Kuwait,2,158051,80798630137.0,4,5,9,PF
2245,2005,Kyrgyzstan,2,156952,2460248026.0,5,4,9,PF
2246,2005,Lebanon,17,1329357,21497336499.0,5,4,9,PF
2247,2005,Mali,1,78425,6247496491.0,2,2,4,F
2248,2005,Mauritania,1,78250,2936019526.0,6,4,10,PF
2249,2005,Mexico,1,78441,877000000000.0,2,2,4,F
2250,2005,Myanmar,8,624311,1860000000000.0,7,7,14,NF
2251,2005,Nepal,70,5480510,8130258041.0,6,5,11,NF
2252,2005,Nigeria,9,707098,176000000000.0,4,4,8,PF
2253,2005,Pakistan,77,6031897,120000000000.0,6,5,11,NF
2254,2005,Peru,2,155941,76060606061.0,2,3,5,F
2255,2005,Philippines,25,1954998,107000000000.0,3,3,6,PF
2256,2005,Qatar,1,77702,44530494505.0,6,5,11,NF
2257,2005,Russia,64,5018609,764000000000.0,6,5,11,NF
2258,2005,Rwanda,1,78485,2932213575.0,6,5,11,NF
2259,2005,Saudi Arabia,1,79165,328000000000.0,7,6,13,NF
2260,2005,Senegal,1,78266,11009032665.0,2,3,5,F
2262,2005,Spain,24,1879926,1150000000000.0,1,1,2,F
2263,2005,Sri Lanka,133,10431001,24405791045.0,3,3,6,PF
2264,2005,Sudan,6,469840,35182105414.0,7,7,14,NF
2265,2005,Sweden,3,234470,392000000000.0,1,1,2,F
2266,2005,Tajikistan,1,78286,2312327536.0,6,5,11,NF
2267,2005,Thailand,155,12141444,189000000000.0,3,3,6,PF
2268,2005,Togo,1,77988,2281482855.0,6,5,11,NF
2269,2005,Trinidad and Tobago,2,157239,15982282462.0,3,2,5,F
2270,2005,Turkey,41,3220720,506000000000.0,3,3,6,PF
2271,2005,Uganda,11,859145,9239221859.0,5,4,9,PF
2272,2005,United Kingdom,29,2272145,2540000000000.0,1,1,2,F
2273,2005,United States,21,1640220,13000000000000.0,1,1,2,F
2274,2005,Uruguay,1,79172,17362857684.0,1,1,2,F
2275,2005,Uzbekistan,2,156203,14307509839.0,7,7,14,NF
2276,2006,Afghanistan,283,22882925,6971285595.0,5,5,10,PF
2277,2006,Algeria,152,12301881,117000000000.0,6,5,11,NF
2278,2006,Australia,2,161605,748000000000.0,1,1,2,F
2279,2006,Austria,1,80404,336000000000.0,1,1,2,F
2280,2006,Bahrain,1,80608,18504760638.0,5,5,10,PF
2281,2006,Bangladesh,23,1854163,71819083684.0,4,4,8,PF
2282,2006,Belarus,1,80286,36954312354.0,7,6,13,NF
2283,2006,Bhutan,1,81975,874989895.6,6,5,11,NF
2284,2006,Bosnia-Herzegovina,1,82000,12864610863.0,3,3,6,PF
2285,2006,Brazil,3,243648,1110000000000.0,2,2,4,F
2286,2006,Burundi,5,403615,1273375020.0,4,5,9,PF
2287,2006,Canada,2,160555,1320000000000.0,1,1,2,F
2288,2006,Central African Republic,1,80440,1460561215.0,5,4,9,PF
2289,2006,Chad,11,891812,7428701809.0,6,6,12,NF
2290,2006,Chile,1,79453,155000000000.0,1,1,2,F
2291,2006,Colombia,43,3462960,162000000000.0,3,3,6,PF
2292,2006,Egypt,5,402442,107000000000.0,6,5,11,NF
2293,2006,Ethiopia,11,881580,15280861835.0,5,5,10,PF
2294,2006,France,34,2732437,2320000000000.0,1,1,2,F
2295,2006,Georgia,3,244459,7745394293.0,3,3,6,PF
2296,2006,Germany,4,322247,2990000000000.0,1,1,2,F
2297,2006,Greece,23,1833776,273000000000.0,1,2,3,F
2298,2006,Guatemala,4,321353,29744368111.0,3,4,7,PF
2299,2006,Guinea-Bissau,1,80160,592365688.1,4,4,8,PF
2300,2006,Guyana,2,160953,2379818383.0,2,3,5,F
2301,2006,Haiti,1,79446,7518107787.0,4,5,9,PF
2302,2006,India,167,13495229,940000000000.0,2,3,5,F
2303,2006,Indonesia,10,808516,365000000000.0,2,3,5,F
2304,2006,Iran,14,1123372,266000000000.0,6,6,12,NF
2305,2006,Iraq,837,67555481,65140147197.0,6,6,12,NF
2306,2006,Ireland,1,80310,232000000000.0,1,1,2,F
2307,2006,Israel,79,6377332,154000000000.0,1,2,3,F
2308,2006,Italy,4,323767,1950000000000.0,1,1,2,F
2309,2006,Jordan,1,81467,15056929760.0,5,4,9,PF
2310,2006,Kenya,2,162335,25825524821.0,3,3,6,PF
2312,2006,Kyrgyzstan,3,241190,2834168889.0,5,4,9,PF
2313,2006,Lebanon,8,646615,22022709852.0,5,4,9,PF
2314,2006,Lesotho,1,79614,1800105590.0,2,3,5,F
2315,2006,Madagascar,1,81401,6395712392.0,4,3,7,PF
2316,2006,Maldives,1,80398,1575200391.0,6,5,11,NF
2317,2006,Mexico,7,565876,975000000000.0,2,3,5,F
2318,2006,Moldova,1,81350,3408244549.0,3,4,7,PF
2319,2006,Myanmar,2,159745,2470000000000.0,7,7,14,NF
2320,2006,Nepal,83,6650182,9043715356.0,5,4,9,PF
2321,2006,Nigeria,37,3003820,236000000000.0,4,4,8,PF
2322,2006,Norway,1,81538,346000000000.0,1,1,2,F
2323,2006,Pakistan,164,13229573,137000000000.0,6,5,11,NF
2324,2006,Peru,1,82049,88643193062.0,2,3,5,F
2325,2006,Philippines,58,4674044,128000000000.0,3,3,6,PF
2326,2006,Russia,56,4527691,990000000000.0,6,5,11,NF
2327,2006,Saudi Arabia,3,241488,377000000000.0,7,6,13,NF
2329,2006,South Korea,1,80753,1050000000000.0,1,2,3,F
2330,2006,Spain,23,1850450,1260000000000.0,1,1,2,F
2331,2006,Sri Lanka,217,17576404,28279814925.0,4,4,8,PF
2332,2006,Sudan,24,1948752,45264519503.0,7,7,14,NF
2333,2006,Sweden,1,80224,423000000000.0,1,1,2,F
2334,2006,Syria,1,81510,154000000000.0,7,6,13,NF
2335,2006,Thailand,202,16303526,222000000000.0,7,4,11,NF
2336,2006,Turkey,43,3476715,557000000000.0,3,3,6,PF
2337,2006,United Kingdom,6,484885,2720000000000.0,1,1,2,F
2338,2006,United States,6,484313,13800000000000.0,1,1,2,F
2339,2006,Zimbabwe,1,80964,5443896500.0,7,6,13,NF
2340,2007,Afghanistan,342,28661761,9747879532.0,5,5,10,PF
2341,2007,Algeria,124,10348947,135000000000.0,6,5,11,NF
2342,2007,Armenia,1,82838,9206301700.0,5,4,9,PF
2343,2007,Austria,1,84693,389000000000.0,1,1,2,F
2344,2007,Azerbaijan,1,82827,33050343783.0,6,5,11,NF
2345,2007,Bangladesh,9,751370,79611888213.0,5,4,9,PF
2346,2007,Belgium,1,82300,470000000000.0,1,1,2,F
2347,2007,Benin,1,82582,8169048690.0,2,2,4,F
2348,2007,Bolivia,3,255959,13120183157.0,3,3,6,PF
2349,2007,Bosnia-Herzegovina,2,167563,15778767411.0,4,3,7,PF
2350,2007,Burundi,3,254793,1356199365.0,4,5,9,PF
2351,2007,Cameroon,1,84876,23928251334.0,6,6,12,NF
2352,2007,Central African Republic,1,83519,1697565949.0,5,5,10,PF
2353,2007,Chad,7,578854,8650138069.0,7,6,13,NF
2354,2007,Chile,8,679139,174000000000.0,1,1,2,F
2355,2007,Colombia,30,2518510,206000000000.0,3,3,6,PF
2356,2007,Cuba,1,82995,58603900000.0,7,7,14,NF
2357,2007,Cyprus,1,84266,23968764030.0,1,1,2,F
2358,2007,Eritrea,2,169473,1317974491.0,7,6,13,NF
2359,2007,Ethiopia,5,415490,19707616773.0,5,5,10,PF
2360,2007,Finland,1,84763,256000000000.0,1,1,2,F
2361,2007,France,16,1351126,2660000000000.0,1,1,2,F
2362,2007,Germany,3,248235,3420000000000.0,1,1,2,F
2363,2007,Greece,15,1249118,318000000000.0,1,2,3,F
2364,2007,Haiti,2,167622,9522763154.0,4,5,9,PF
2365,2007,India,149,12461988,1220000000000.0,2,3,5,F
2366,2007,Indonesia,2,166109,432000000000.0,2,3,5,F
2367,2007,Iran,9,752743,350000000000.0,6,6,12,NF
2368,2007,Iraq,1046,87643353,88837055195.0,6,6,12,NF
2369,2007,Ireland,1,83058,270000000000.0,1,1,2,F
2370,2007,Israel,49,4113338,179000000000.0,1,2,3,F
2371,2007,Jamaica,1,84173,12799593018.0,2,3,5,F
2372,2007,Kenya,12,1003098,31958195182.0,4,3,7,PF
2374,2007,Kyrgyzstan,1,82610,3802566171.0,5,4,9,PF
2375,2007,Latvia,1,83069,31054350978.0,2,1,3,F
2376,2007,Lebanon,18,1502682,24827355015.0,5,4,9,PF
2377,2007,Libya,1,82745,67516236338.0,7,7,14,NF
2378,2007,Maldives,1,84318,1868383461.0,6,5,11,NF
2379,2007,Mali,5,419641,8156532186.0,2,3,5,F
2380,2007,Mexico,10,830634,1050000000000.0,2,3,5,F
2381,2007,Montenegro,1,83999,3680711744.0,3,3,6,PF
2382,2007,Morocco,6,497689,79041294874.0,5,4,9,PF
2383,2007,Mozambique,1,84107,10450843291.0,3,3,6,PF
2384,2007,Myanmar,3,250938,3530000000000.0,7,7,14,NF
2385,2007,Nepal,90,7528025,10325618017.0,5,4,9,PF
2386,2007,Niger,7,589848,5731485267.0,3,4,7,PF
2387,2007,Nigeria,61,5081941,276000000000.0,4,4,8,PF
2388,2007,Pakistan,260,21844210,152000000000.0,6,5,11,NF
2389,2007,Papua New Guinea,1,84812,9545177014.0,3,3,6,PF
2390,2007,Peru,4,336827,102000000000.0,2,3,5,F
2391,2007,Philippines,65,5429684,156000000000.0,4,3,7,PF
2392,2007,Russia,51,4288330,1300000000000.0,6,5,11,NF
2393,2007,Saudi Arabia,1,82499,416000000000.0,7,6,13,NF
2394,2007,Senegal,1,82501,13994218939.0,2,3,5,F
2396,2007,South Africa,2,169645,333000000000.0,2,2,4,F
2397,2007,Spain,11,922247,1470000000000.0,1,1,2,F
2398,2007,Sri Lanka,132,11039300,32350248411.0,4,4,8,PF
2399,2007,Sudan,23,1915397,59440139775.0,7,7,14,NF
2400,2007,Switzerland,2,168179,494000000000.0,1,1,2,F
2401,2007,Tajikistan,1,84906,3719506173.0,6,5,11,NF
2402,2007,Thailand,293,24512736,263000000000.0,6,4,10,PF
2403,2007,Tunisia,1,82135,38914078352.0,7,5,12,NF
2404,2007,Turkey,29,2428916,681000000000.0,3,3,6,PF
2405,2007,Uganda,1,84660,11902564401.0,5,4,9,PF
2406,2007,Ukraine,1,84771,149000000000.0,3,2,5,F
2407,2007,United Kingdom,20,1665752,3110000000000.0,1,1,2,F
2408,2007,United States,8,666628,14500000000000.0,1,1,2,F
2409,2007,Zimbabwe,1,82706,5291950100.0,7,6,13,NF
2410,2008,Afghanistan,414,36247634,10109305183.0,5,6,11,NF
2411,2008,Algeria,107,9390158,171000000000.0,6,5,11,NF
2412,2008,Australia,3,266206,1060000000000.0,1,1,2,F
2413,2008,Austria,7,620838,430000000000.0,1,1,2,F
2414,2008,Azerbaijan,2,177130,48852482960.0,6,5,11,NF
2415,2008,Bahrain,1,86335,25710904255.0,5,5,10,PF
2416,2008,Bangladesh,19,1669989,91631278239.0,4,4,8,PF
2417,2008,Belarus,1,87754,60763483146.0,7,6,13,NF
2418,2008,Bhutan,3,261727,1227808791.0,4,5,9,PF
2419,2008,Bosnia-Herzegovina,4,357296,19112739398.0,4,3,7,PF
2420,2008,Bulgaria,2,175482,54438966420.0,2,2,4,F
2421,2008,Burundi,7,615102,1611835902.0,4,5,9,PF
2422,2008,Cambodia,2,175789,10351914093.0,6,5,11,NF
2423,2008,Cameroon,1,87343,27715144580.0,6,6,12,NF
2424,2008,Canada,5,442801,1550000000000.0,1,1,2,F
2425,2008,Central African Republic,2,178019,1985240986.0,5,5,10,PF
2426,2008,Chad,8,695419,10393834721.0,7,6,13,NF
2427,2008,Chile,4,351505,180000000000.0,1,1,2,F
2428,2008,China,20,1756188,4590000000000.0,7,6,13,NF
2429,2008,Colombia,133,11735061,242000000000.0,3,4,7,PF
2430,2008,Croatia,2,174150,70750646248.0,2,2,4,F
2431,2008,Czech Republic,2,175030,237000000000.0,1,1,2,F
2432,2008,Denmark,1,90155,353000000000.0,1,1,2,F
2433,2008,Ecuador,2,176391,61762635000.0,3,3,6,PF
2434,2008,Egypt,1,89458,163000000000.0,6,5,11,NF
2435,2008,Eritrea,2,174365,1380188800.0,7,6,13,NF
2436,2008,Ethiopia,8,701818,27066912635.0,5,5,10,PF
2437,2008,Finland,1,89145,285000000000.0,1,1,2,F
2438,2008,France,13,1138318,2920000000000.0,1,1,2,F
2439,2008,Georgia,33,2900910,12795076469.0,4,4,8,PF
2440,2008,Germany,3,262204,3730000000000.0,1,1,2,F
2441,2008,Greece,53,4636128,354000000000.0,1,2,3,F
2442,2008,Guyana,3,257046,3025187924.0,2,3,5,F
2443,2008,Hungary,2,172920,158000000000.0,1,1,2,F
2444,2008,India,534,47064252,1200000000000.0,2,3,5,F
2445,2008,Indonesia,13,1153213,510000000000.0,2,3,5,F
2446,2008,Iran,8,699754,412000000000.0,6,6,12,NF
2447,2008,Iraq,1106,96784353,132000000000.0,6,6,12,NF
2448,2008,Ireland,5,441169,274000000000.0,1,1,2,F
2449,2008,Israel,129,11208416,217000000000.0,1,2,3,F
2450,2008,Italy,2,172788,2400000000000.0,1,2,3,F
2451,2008,Japan,3,265777,5110000000000.0,1,2,3,F
2452,2008,Kazakhstan,1,85649,133000000000.0,6,5,11,NF
2453,2008,Kenya,11,960636,35895153328.0,4,3,7,PF
2455,2008,Lebanon,58,5064828,29118916106.0,5,4,9,PF
2456,2008,Liberia,1,87362,1726000000.0,3,4,7,PF
2457,2008,Libya,1,88642,87140405361.0,7,7,14,NF
2458,2008,Malaysia,2,175929,231000000000.0,4,4,8,PF
2459,2008,Maldives,1,85504,2271646188.0,4,4,8,PF
2460,2008,Mali,9,792716,9838404005.0,2,3,5,F
2461,2008,Mauritania,2,174506,5206444407.0,6,5,11,NF
2462,2008,Mexico,8,699471,1110000000000.0,2,3,5,F
2463,2008,Myanmar,20,1750496,4880000000000.0,7,7,14,NF
2464,2008,Nepal,120,10482094,12545438605.0,4,4,8,PF
2465,2008,Netherlands,1,90042,948000000000.0,1,1,2,F
2466,2008,New Zealand,5,437593,133000000000.0,1,1,2,F
2467,2008,Niger,9,786581,7297600897.0,3,4,7,PF
2468,2008,Nigeria,76,6674936,339000000000.0,5,4,9,PF
2469,2008,Pakistan,568,50075715,170000000000.0,4,5,9,PF
2470,2008,Peru,1,86479,121000000000.0,2,3,5,F
2471,2008,Philippines,276,24361283,182000000000.0,4,3,7,PF
2472,2008,Romania,1,86212,214000000000.0,2,2,4,F
2473,2008,Russia,170,14995736,1660000000000.0,6,5,11,NF
2474,2008,Rwanda,1,90126,5177015141.0,6,5,11,NF
2475,2008,Senegal,2,173683,16853991177.0,3,3,6,PF
2476,2008,Serbia,4,348998,52194221469.0,3,2,5,F
2478,2008,South Africa,1,86681,316000000000.0,2,2,4,F
2479,2008,Spain,37,3252156,1630000000000.0,1,1,2,F
2480,2008,Sri Lanka,100,8753277,40713812310.0,4,4,8,PF
2481,2008,Sudan,32,2825006,64831935604.0,7,7,14,NF
2482,2008,Sweden,1,86701,518000000000.0,1,1,2,F
2483,2008,Syria,1,88930,218000000000.0,7,6,13,NF
2484,2008,Tanzania,1,85444,27941177435.0,4,3,7,PF
2485,2008,Thailand,200,17519608,291000000000.0,5,4,9,PF
2486,2008,Tunisia,2,175120,44860969077.0,7,5,12,NF
2487,2008,Turkey,32,2808513,770000000000.0,3,3,6,PF
2488,2008,Uganda,7,611950,14440404021.0,5,4,9,PF
2489,2008,Ukraine,1,86529,188000000000.0,3,2,5,F
2490,2008,United Kingdom,39,3420635,2940000000000.0,1,1,2,F
2491,2008,United States,18,1566554,14700000000000.0,1,1,2,F
2492,2008,Zimbabwe,5,441133,4415702800.0,7,6,13,NF
2493,2009,Afghanistan,503,46637540,12416161049.0,6,6,12,NF
2494,2009,Albania,1,92811,12044208086.0,3,3,6,PF
2495,2009,Algeria,108,10001074,137000000000.0,6,5,11,NF
2496,2009,Angola,1,93023,70307163678.0,6,5,11,NF
2497,2009,Argentina,1,93098,333000000000.0,2,2,4,F
2498,2009,Armenia,1,90608,8647936748.0,6,4,10,PF
2499,2009,Australia,1,93899,928000000000.0,1,1,2,F
2500,2009,Austria,3,275483,400000000000.0,1,1,2,F
2501,2009,Azerbaijan,2,183121,44291490421.0,6,5,11,NF
2502,2009,Bangladesh,27,2496502,102000000000.0,3,4,7,PF
2503,2009,Belgium,1,90241,481000000000.0,1,1,2,F
2504,2009,Bolivia,3,277912,17339992165.0,3,3,6,PF
2505,2009,Bosnia-Herzegovina,1,91752,17613836527.0,4,3,7,PF
2506,2009,Cameroon,1,92685,27932971683.0,6,6,12,NF
2507,2009,Canada,4,365771,1370000000000.0,1,1,2,F
2508,2009,Central African Republic,5,468706,2059094048.0,5,5,10,PF
2509,2009,Chad,3,282556,9290728773.0,7,6,13,NF
2510,2009,Chile,8,734395,172000000000.0,1,1,2,F
2511,2009,China,7,644016,5100000000000.0,7,6,13,NF
2512,2009,Colombia,139,12876128,232000000000.0,3,4,7,PF
2513,2009,Croatia,1,92900,63084004705.0,1,2,3,F
2514,2009,Czech Republic,1,92717,207000000000.0,1,1,2,F
2515,2009,Ecuador,1,90450,62519686000.0,3,3,6,PF
2516,2009,Egypt,2,182728,189000000000.0,6,5,11,NF
2517,2009,Equatorial Guinea,1,90799,15027795173.0,7,7,14,NF
2518,2009,Eritrea,1,90882,1856695551.0,7,7,14,NF
2519,2009,Ethiopia,2,182764,32437389116.0,5,5,10,PF
2520,2009,France,9,822677,2690000000000.0,1,1,2,F
2521,2009,Georgia,25,2309053,10766836277.0,4,4,8,PF
2522,2009,Germany,4,372996,3400000000000.0,1,1,2,F
2523,2009,Greece,115,10589715,330000000000.0,1,2,3,F
2524,2009,Guinea-Bissau,1,92231,830126470.0,4,4,8,PF
2525,2009,Honduras,8,754806,14486159608.0,4,4,8,PF
2526,2009,Hungary,1,90873,131000000000.0,1,1,2,F
2527,2009,India,672,62213819,1340000000000.0,2,3,5,F
2528,2009,Indonesia,19,1758818,540000000000.0,2,3,5,F
2529,2009,Iran,15,1377460,416000000000.0,6,6,12,NF
2530,2009,Iraq,1137,105431759,112000000000.0,5,6,11,NF
2531,2009,Israel,36,3269852,208000000000.0,1,2,3,F
2532,2009,Italy,4,373770,2190000000000.0,1,2,3,F
2533,2009,Japan,1,90853,5290000000000.0,1,2,3,F
2534,2009,Kenya,1,92848,42347217913.0,4,4,8,PF
2535,2009,Kosovo,1,91087,5015894693.0,5,4,9,PF
2536,2009,Lebanon,14,1295757,35399582929.0,5,3,8,PF
2537,2009,Lesotho,1,91612,1740830511.0,3,3,6,PF
2538,2009,Madagascar,1,92849,9616879571.0,6,4,10,PF
2539,2009,Malaysia,1,91350,202000000000.0,4,4,8,PF
2540,2009,Mali,6,552410,10232036863.0,2,3,5,F
2541,2009,Mauritania,5,465578,4714592493.0,6,5,11,NF
2542,2009,Mexico,1,92521,900000000000.0,2,3,5,F
2543,2009,Moldova,1,93988,5439422031.0,3,4,7,PF
2544,2009,Myanmar,14,1297742,5580000000000.0,7,7,14,NF
2545,2009,Nepal,39,3569735,12854985464.0,4,4,8,PF
2546,2009,Netherlands,1,91747,868000000000.0,1,1,2,F
2547,2009,Niger,4,371181,7352131669.0,5,4,9,PF
2548,2009,Nigeria,42,3867125,295000000000.0,5,4,9,PF
2549,2009,Pakistan,667,61564128,168000000000.0,4,5,9,PF
2550,2009,Panama,1,90815,27116635565.0,1,2,3,F
2551,2009,Peru,4,366774,121000000000.0,2,3,5,F
2552,2009,Philippines,229,21126873,176000000000.0,4,3,7,PF
2553,2009,Russia,152,14097676,1220000000000.0,6,5,11,NF
2554,2009,Rwanda,1,93739,5671332138.0,6,5,11,NF
2555,2009,Saudi Arabia,3,281664,429000000000.0,7,6,13,NF
2556,2009,Senegal,3,281937,16145868285.0,3,3,6,PF
2557,2009,Serbia,3,278331,45162894381.0,2,2,4,F
2559,2009,Spain,21,1940505,1490000000000.0,1,1,2,F
2560,2009,Sri Lanka,37,3370737,42066217872.0,4,4,8,PF
2561,2009,Sudan,26,2413941,51621044077.0,7,7,14,NF
2562,2009,Sweden,1,90894,437000000000.0,1,1,2,F
2563,2009,Tajikistan,1,91549,4979481980.0,6,5,11,NF
2564,2009,Thailand,298,27665920,282000000000.0,5,4,9,PF
2565,2009,Turkey,13,1199444,649000000000.0,3,3,6,PF
2566,2009,Uganda,2,185277,25127805566.0,5,4,9,PF
2567,2009,Ukraine,2,181780,122000000000.0,3,2,5,F
2568,2009,United Kingdom,23,2121129,2430000000000.0,1,1,2,F
2569,2009,United States,12,1113612,14400000000000.0,1,1,2,F
2570,2009,Uzbekistan,2,184139,33689223673.0,7,7,14,NF
2571,2010,Afghanistan,542,52754952,15856678596.0,6,6,12,NF
2572,2010,Algeria,100,9736407,161000000000.0,6,5,11,NF
2573,2010,Angola,2,193939,83799496611.0,6,5,11,NF
2574,2010,Argentina,5,489388,424000000000.0,2,2,4,F
2575,2010,Australia,1,95226,1150000000000.0,1,1,2,F
2576,2010,Bahrain,2,193924,25713271277.0,6,5,11,NF
2577,2010,Bangladesh,22,2121401,115000000000.0,3,4,7,PF
2578,2010,Belarus,2,196050,57222490769.0,7,6,13,NF
2579,2010,Bosnia-Herzegovina,1,97086,17176781046.0,4,3,7,PF
2580,2010,Burundi,29,2816316,2032135247.0,5,5,10,PF
2581,2010,Cameroon,3,290755,27507499709.0,6,6,12,NF
2582,2010,Canada,2,194256,1620000000000.0,1,1,2,F
2583,2010,Central African Republic,13,1253665,2142591376.0,5,5,10,PF
2584,2010,Chad,1,96825,10668102735.0,7,6,13,NF
2585,2010,Chile,5,489823,219000000000.0,1,1,2,F
2586,2010,China,1,97801,6090000000000.0,7,6,13,NF
2587,2010,Colombia,136,13220652,287000000000.0,3,4,7,PF
2588,2010,Denmark,1,98144,322000000000.0,1,1,2,F
2589,2010,Egypt,2,192554,219000000000.0,6,5,11,NF
2590,2010,Eritrea,1,95380,1589515447.0,7,7,14,NF
2591,2010,Ethiopia,2,192241,29933790334.0,6,6,12,NF
2592,2010,France,3,289454,2640000000000.0,1,1,2,F
2593,2010,Georgia,7,683750,12243505583.0,4,3,7,PF
2594,2010,Germany,1,98896,3400000000000.0,1,1,2,F
2595,2010,Greece,49,4743418,297000000000.0,1,2,3,F
2596,2010,India,663,64496083,1680000000000.0,2,3,5,F
2597,2010,Indonesia,4,380237,755000000000.0,2,3,5,F
2598,2010,Iran,14,1363365,487000000000.0,6,6,12,NF
2599,2010,Iraq,1179,114843509,139000000000.0,5,6,11,NF
2600,2010,Ireland,4,385340,222000000000.0,1,1,2,F
2601,2010,Israel,14,1364073,235000000000.0,1,2,3,F
2602,2010,Italy,10,977923,2130000000000.0,1,2,3,F
2603,2010,Jordan,2,192536,27133804225.0,6,5,11,NF
2604,2010,Kenya,12,1170035,45405587557.0,4,3,7,PF
2605,2010,Kosovo,1,97173,5344014318.0,5,4,9,PF
2606,2010,Kyrgyzstan,1,96864,4794357795.0,5,5,10,PF
2607,2010,Lebanon,5,480143,38443907042.0,5,3,8,PF
2608,2010,Mali,1,97685,10689167195.0,2,3,5,F
2609,2010,Mauritania,1,97875,5628882266.0,6,5,11,NF
2610,2010,Mexico,5,487379,1060000000000.0,3,3,6,PF
2611,2010,Myanmar,11,1055594,6570000000000.0,7,7,14,NF
2612,2010,Nepal,38,3685915,16002656434.0,4,4,8,PF
2613,2010,Netherlands,1,98981,847000000000.0,1,1,2,F
2614,2010,Niger,3,290104,7851191899.0,5,4,9,PF
2615,2010,Nigeria,63,6169623,361000000000.0,4,4,8,PF
2616,2010,Norway,1,95094,429000000000.0,1,1,2,F
2617,2010,Pakistan,713,69280839,177000000000.0,4,5,9,PF
2618,2010,Paraguay,2,195353,27237782850.0,3,3,6,PF
2619,2010,Philippines,205,19908360,208000000000.0,3,3,6,PF
2620,2010,Poland,1,98716,480000000000.0,1,1,2,F
2621,2010,Russia,251,24494398,1520000000000.0,6,5,11,NF
2622,2010,Rwanda,8,769983,6121234529.0,6,5,11,NF
2623,2010,Senegal,1,98866,16121314671.0,3,3,6,PF
2624,2010,Serbia,1,95368,41819468692.0,2,2,4,F
2626,2010,Spain,3,293519,1420000000000.0,1,1,2,F
2627,2010,Sri Lanka,3,285270,56725749222.0,5,4,9,PF
2628,2010,Sudan,28,2733562,58962978034.0,7,7,14,NF
2629,2010,Sweden,3,295424,496000000000.0,1,1,2,F
2630,2010,Tajikistan,1,98011,5642178580.0,6,5,11,NF
2631,2010,Tanzania,1,96547,32014249841.0,3,3,6,PF
2632,2010,Thailand,253,24550479,341000000000.0,5,4,9,PF
2633,2010,Trinidad and Tobago,1,97276,22157948396.0,2,2,4,F
2634,2010,Turkey,20,1958984,777000000000.0,3,3,6,PF
2635,2010,Uganda,6,589633,26673441667.0,5,4,9,PF
2636,2010,Ukraine,4,393783,141000000000.0,3,3,6,PF
2637,2010,United Arab Emirates,2,196373,290000000000.0,6,5,11,NF
2638,2010,United Kingdom,57,5542482,2490000000000.0,1,1,2,F
2639,2010,United States,17,1653086,15000000000000.0,1,1,2,F
2640,2010,Zimbabwe,1,98772,12041655200.0,6,6,12,NF
2641,2011,Afghanistan,421,43265218,17805113119.0,6,6,12,NF
2642,2011,Algeria,15,1530555,200000000000.0,6,5,11,NF
2643,2011,Argentina,1,104674,530000000000.0,2,2,4,F
2644,2011,Austria,1,99951,431000000000.0,1,1,2,F
2645,2011,Bahrain,1,104407,28776595745.0,6,6,12,NF
2646,2011,Bangladesh,13,1313541,129000000000.0,3,4,7,PF
2647,2011,Belarus,1,101087,61757788945.0,7,6,13,NF
2648,2011,Bhutan,1,103410,1777101317.0,4,5,9,PF
2649,2011,Bosnia-Herzegovina,1,103653,18644723854.0,4,3,7,PF
2650,2011,Bulgaria,2,204933,57678241024.0,2,2,4,F
2651,2011,Burundi,8,819124,2235820868.0,5,5,10,PF
2652,2011,Cameroon,3,303851,30630912185.0,6,6,12,NF
2653,2011,Central African Republic,3,303676,2437982840.0,5,5,10,PF
2654,2011,Chile,6,620791,252000000000.0,1,1,2,F
2655,2011,China,4,411469,7550000000000.0,7,6,13,NF
2656,2011,Colombia,94,9551721,335000000000.0,3,4,7,PF
2657,2011,Czech Republic,1,102973,230000000000.0,1,1,2,F
2658,2011,Ecuador,1,104194,79276664000.0,3,3,6,PF
2659,2011,Egypt,18,1845203,236000000000.0,6,5,11,NF
2660,2011,Eritrea,1,104366,2065001626.0,7,7,14,NF
2661,2011,Estonia,1,102701,23183616046.0,1,1,2,F
2662,2011,Ethiopia,3,302631,31952763089.0,6,6,12,NF
2663,2011,France,8,809740,2860000000000.0,1,1,2,F
2664,2011,Georgia,3,308064,15107441447.0,4,3,7,PF
2665,2011,Germany,8,822125,3740000000000.0,1,1,2,F
2666,2011,Greece,11,1120746,283000000000.0,2,2,4,F
2667,2011,Honduras,1,104473,17588098575.0,4,4,8,PF
2668,2011,India,645,65786328,1820000000000.0,2,3,5,F
2669,2011,Indonesia,21,2149053,893000000000.0,2,3,5,F
2670,2011,Iran,13,1323272,581000000000.0,6,6,12,NF
2671,2011,Iraq,1308,133980047,186000000000.0,5,6,11,NF
2672,2011,Ireland,4,406575,239000000000.0,1,1,2,F
2673,2011,Israel,51,5207484,262000000000.0,1,2,3,F
2674,2011,Italy,5,515027,2290000000000.0,1,1,2,F
2675,2011,Kazakhstan,5,516859,193000000000.0,6,5,11,NF
2676,2011,Kenya,42,4350666,46869457318.0,4,3,7,PF
2677,2011,Kosovo,1,104224,6341737194.0,5,4,9,PF
2678,2011,Kuwait,1,101620,154000000000.0,4,5,9,PF
2679,2011,Kyrgyzstan,1,101454,6197766119.0,5,5,10,PF
2680,2011,Lebanon,10,1034276,39927125961.0,5,4,9,PF
2681,2011,Libya,2,207697,34699395524.0,7,6,13,NF
2682,2011,Madagascar,1,100544,11551819618.0,6,4,10,PF
2683,2011,Mali,4,410428,12995113407.0,2,3,5,F
2684,2011,Mauritania,3,302583,6764635687.0,6,5,11,NF
2685,2011,Mexico,2,206706,1180000000000.0,3,3,6,PF
2686,2011,Morocco,1,101350,101000000000.0,5,4,9,PF
2687,2011,Myanmar,2,207999,7900000000000.0,7,6,13,NF
2688,2011,Nepal,46,4671855,21621710003.0,4,4,8,PF
2689,2011,Netherlands,2,203431,904000000000.0,1,1,2,F
2690,2011,Niger,2,201790,8772951262.0,3,4,7,PF
2691,2011,Nigeria,175,17922454,405000000000.0,4,4,8,PF
2692,2011,Norway,3,304784,498000000000.0,1,1,2,F
2693,2011,Pakistan,1012,103291961,214000000000.0,4,5,9,PF
2694,2011,Paraguay,4,399672,33756238767.0,3,3,6,PF
2695,2011,Philippines,151,15434429,234000000000.0,3,3,6,PF
2696,2011,Portugal,2,208637,245000000000.0,1,1,2,F
2697,2011,Russia,188,19129977,2050000000000.0,6,5,11,NF
2698,2011,Rwanda,2,202494,6881038270.0,6,5,11,NF
2699,2011,Saudi Arabia,2,205289,671000000000.0,7,7,14,NF
2700,2011,Senegal,4,413887,17814284622.0,3,3,6,PF
2702,2011,Sudan,38,3879541,55018567211.0,7,7,14,NF
2703,2011,Sweden,1,102344,574000000000.0,1,1,2,F
2704,2011,Switzerland,3,301055,722000000000.0,1,1,2,F
2705,2011,Syria,49,5069767,64315437939.0,7,7,14,NF
2706,2011,Thailand,182,18599728,371000000000.0,4,4,8,PF
2707,2011,Tunisia,3,305729,48122838145.0,3,4,7,PF
2708,2011,Turkey,51,5231765,839000000000.0,3,3,6,PF
2709,2011,Ukraine,3,304089,169000000000.0,4,3,7,PF
2710,2011,United Kingdom,47,4761082,2670000000000.0,1,1,2,F
2711,2011,United States,10,1013055,15500000000000.0,1,1,2,F
2712,2011,Zimbabwe,1,101904,14101920300.0,6,6,12,NF
2713,2012,Afghanistan,1469,159936125,19907317066.0,6,6,12,NF
2714,2012,Algeria,41,4433449,209000000000.0,6,5,11,NF
2715,2012,Argentina,2,215534,546000000000.0,2,2,4,F
2716,2012,Bahrain,26,2850908,30749308511.0,6,6,12,NF
2717,2012,Bangladesh,18,1964343,133000000000.0,3,4,7,PF
2718,2012,Belarus,3,332679,65685102555.0,7,6,13,NF
2719,2012,Belgium,1,106342,496000000000.0,1,1,2,F
2720,2012,Bolivia,1,112034,27084497483.0,3,3,6,PF
2721,2012,Brazil,1,107252,2470000000000.0,2,2,4,F
2722,2012,Bulgaria,2,218500,54300857424.0,2,2,4,F
2723,2012,Burundi,4,430507,2333308099.0,5,5,10,PF
2724,2012,Canada,3,328861,1830000000000.0,1,1,2,F
2725,2012,Central African Republic,4,441163,2510126699.0,5,5,10,PF
2726,2012,Chile,2,214037,267000000000.0,1,1,2,F
2727,2012,China,4,434043,8530000000000.0,7,6,13,NF
2728,2012,Colombia,115,12530761,371000000000.0,3,4,7,PF
2729,2012,Cyprus,1,113263,24978513427.0,1,1,2,F
2730,2012,Ecuador,1,111212,87924544000.0,3,3,6,PF
2731,2012,Egypt,49,5366121,279000000000.0,5,5,10,PF
2732,2012,Ethiopia,3,317260,43310721414.0,6,6,12,NF
2733,2012,France,66,7263379,2680000000000.0,1,1,2,F
2734,2012,Georgia,3,319188,16488403076.0,3,3,6,PF
2735,2012,Germany,5,545275,3530000000000.0,1,1,2,F
2736,2012,Greece,23,2507302,242000000000.0,2,2,4,F
2737,2012,Guatemala,1,105122,49593961142.0,3,4,7,PF
2738,2012,Guinea-Bissau,1,106470,989271229.6,6,5,11,NF
2739,2012,Iceland,1,105521,14751508134.0,1,1,2,F
2740,2012,India,613,66863914,1830000000000.0,2,3,5,F
2741,2012,Indonesia,39,4291079,918000000000.0,2,3,5,F
2742,2012,Iran,5,541295,599000000000.0,6,6,12,NF
2743,2012,Iraq,1437,156274145,218000000000.0,6,6,12,NF
2744,2012,Ireland,29,3190349,226000000000.0,1,1,2,F
2745,2012,Israel,65,7239324,258000000000.0,1,2,3,F
2746,2012,Italy,10,1089531,2090000000000.0,2,1,3,F
2747,2012,Jordan,2,221715,31634561690.0,6,5,11,NF
2748,2012,Kazakhstan,4,437150,208000000000.0,6,5,11,NF
2749,2012,Kenya,80,8776022,56396706006.0,4,4,8,PF
2750,2012,Kosovo,4,435728,6163785173.0,5,4,9,PF
2751,2012,Lebanon,15,1629819,44035991893.0,5,4,9,PF
2752,2012,Liberia,1,108082,2791614000.0,3,4,7,PF
2753,2012,Libya,57,6300356,81873662519.0,4,5,9,PF
2754,2012,Madagascar,1,110468,11578974888.0,6,4,10,PF
2755,2012,Malaysia,2,221702,314000000000.0,4,4,8,PF
2756,2012,Maldives,1,108425,2886170572.0,5,4,9,PF
2757,2012,Mali,19,2044809,12442036265.0,7,5,12,NF
2758,2012,Mexico,16,1725151,1200000000000.0,3,3,6,PF
2759,2012,Moldova,1,108820,8709165249.0,3,3,6,PF
2760,2012,Mozambique,1,106273,16350804543.0,4,3,7,PF
2761,2012,Myanmar,17,1844399,114000000000.0,6,5,11,NF
2762,2012,Nepal,46,4956951,21703106502.0,4,4,8,PF
2763,2012,Niger,1,111609,9426913349.0,3,4,7,PF
2764,2012,Nigeria,616,66924104,456000000000.0,4,4,8,PF
2765,2012,Pakistan,1654,180821368,224000000000.0,4,5,9,PF
2766,2012,Paraguay,4,445447,33296438306.0,3,3,6,PF
2767,2012,Peru,9,984990,193000000000.0,2,3,5,F
2768,2012,Philippines,249,27203172,262000000000.0,3,3,6,PF
2769,2012,Russia,151,16512679,2210000000000.0,6,5,11,NF
2770,2012,Rwanda,6,642878,7650300320.0,6,6,12,NF
2771,2012,Saudi Arabia,6,647638,736000000000.0,7,7,14,NF
2772,2012,Senegal,12,1279505,17660871726.0,2,3,5,F
2773,2012,Serbia,3,326073,43309252921.0,2,2,4,F
2775,2012,South Africa,4,439124,434000000000.0,2,2,4,F
2776,2012,South Sudan,5,535684,11931472169.0,6,5,11,NF
2777,2012,Spain,1,110973,1320000000000.0,1,1,2,F
2778,2012,Sri Lanka,4,437935,68434409315.0,5,4,9,PF
2779,2012,Sudan,40,4378844,37632919967.0,7,7,14,NF
2780,2012,Sweden,2,221436,552000000000.0,1,1,2,F
2781,2012,Syria,180,19730465,42807315976.0,7,7,14,NF
2782,2012,Tajikistan,5,548005,7633049792.0,6,6,12,NF
2783,2012,Thailand,280,30587403,398000000000.0,4,4,8,PF
2784,2012,Tunisia,3,333616,47311196335.0,3,4,7,PF
2785,2012,Turkey,188,20658776,881000000000.0,3,4,7,PF
2786,2012,Uganda,4,438544,27305915761.0,5,4,9,PF
2787,2012,Ukraine,8,857775,183000000000.0,4,3,7,PF
2788,2012,United Kingdom,55,6013234,2720000000000.0,1,1,2,F
2789,2012,United States,20,2152494,16200000000000.0,1,1,2,F
2790,2013,Afghanistan,1443,171865325,20146404996.0,6,6,12,NF
2791,2013,Albania,1,124625,12776220507.0,3,3,6,PF
2792,2013,Algeria,22,2582066,210000000000.0,6,5,11,NF
2793,2013,Argentina,2,242453,552000000000.0,2,2,4,F
2794,2013,Armenia,1,114152,11121465767.0,5,4,9,PF
2795,2013,Australia,1,120878,1580000000000.0,1,1,2,F
2796,2013,Austria,1,114204,430000000000.0,1,1,2,F
2797,2013,Bahamas,1,123599,10494600000.0,1,1,2,F
2798,2013,Bahrain,52,6154862,32539468085.0,6,6,12,NF
2799,2013,Bangladesh,139,16322772,150000000000.0,3,4,7,PF
2800,2013,Belize,1,113721,1579411253.0,1,2,3,F
2801,2013,Bosnia-Herzegovina,1,113677,18172335776.0,3,3,6,PF
2802,2013,Brazil,3,350892,2470000000000.0,2,2,4,F
2803,2013,Bulgaria,3,346655,55810138436.0,2,2,4,F
2804,2013,Burkina Faso,1,120815,13444301139.0,5,3,8,PF
2805,2013,Burundi,2,236313,2451625333.0,5,5,10,PF
2806,2013,Cambodia,2,242437,15227991395.0,6,5,11,NF
2807,2013,Cameroon,3,361465,33728622819.0,6,6,12,NF
2808,2013,Canada,4,466191,1850000000000.0,1,1,2,F
2809,2013,Central African Republic,20,2401188,1691544192.0,7,7,14,NF
2810,2013,Chile,5,579191,278000000000.0,1,1,2,F
2811,2013,China,12,1439314,9570000000000.0,7,6,13,NF
2812,2013,Colombia,150,17755959,382000000000.0,3,4,7,PF
2813,2013,Croatia,2,227163,58889082315.0,1,2,3,F
2814,2013,Cyprus,9,1086152,23900872626.0,1,1,2,F
2815,2013,Czech Republic,1,113814,212000000000.0,1,1,2,F
2816,2013,Denmark,1,114254,344000000000.0,1,1,2,F
2817,2013,Dominican Republic,1,121962,62682163837.0,2,3,5,F
2818,2013,Ecuador,2,232361,95129659000.0,3,3,6,PF
2819,2013,Egypt,321,38638079,288000000000.0,6,5,11,NF
2820,2013,Ethiopia,5,600555,47648211133.0,6,6,12,NF
2821,2013,France,18,2168218,2810000000000.0,1,1,2,F
2822,2013,Georgia,2,235657,17189551521.0,3,3,6,PF
2823,2013,Greece,54,6346100,239000000000.0,2,2,4,F
2824,2013,Guatemala,6,710016,52996540704.0,3,4,7,PF
2825,2013,Guinea,2,229759,8376613843.0,5,5,10,PF
2826,2013,Honduras,2,243639,18372173381.0,4,4,8,PF
2827,2013,India,694,82818720,1860000000000.0,2,3,5,F
2828,2013,Indonesia,32,3770474,913000000000.0,2,4,6,PF
2829,2013,Iran,11,1338926,460000000000.0,6,6,12,NF
2830,2013,Iraq,2852,343129300,235000000000.0,5,6,11,NF
2831,2013,Ireland,27,3193383,238000000000.0,1,1,2,F
2832,2013,Israel,37,4427937,294000000000.0,1,2,3,F
2833,2013,Italy,7,825997,2140000000000.0,1,1,2,F
2834,2013,Japan,1,124093,5210000000000.0,1,1,2,F
2835,2013,Jordan,1,117205,34454440141.0,6,5,11,NF
2836,2013,Kazakhstan,4,474380,237000000000.0,6,5,11,NF
2837,2013,Kenya,80,9432854,61671425370.0,4,4,8,PF
2838,2013,Kosovo,6,719834,6735731173.0,5,4,9,PF
2839,2013,Lebanon,121,14409111,46909335551.0,5,4,9,PF
2840,2013,Libya,291,35052402,65502870174.0,4,5,9,PF
2841,2013,Madagascar,2,243592,12423555269.0,5,4,9,PF
2842,2013,Malaysia,13,1521147,323000000000.0,4,4,8,PF
2843,2013,Maldives,3,368499,3295011382.0,4,4,8,PF
2844,2013,Mali,58,6883578,13242691430.0,5,4,9,PF
2845,2013,Mexico,8,920211,1270000000000.0,3,3,6,PF
2846,2013,Montenegro,2,245284,4464260489.0,3,2,5,F
2847,2013,Mozambique,18,2185677,16974320551.0,4,3,7,PF
2848,2013,Myanmar,18,2168548,60572254371.0,6,5,11,NF
2849,2013,Nepal,104,12692255,22162208956.0,4,4,8,PF
2850,2013,Niger,4,470703,10224897935.0,3,4,7,PF
2851,2013,Nigeria,347,41008996,509000000000.0,4,4,8,PF
2852,2013,Pakistan,2214,262548365,231000000000.0,4,5,9,PF
2853,2013,Paraguay,10,1185180,38651334288.0,3,3,6,PF
2854,2013,Peru,13,1524301,201000000000.0,2,3,5,F
2855,2013,Philippines,651,77496787,284000000000.0,3,3,6,PF
2856,2013,Russia,145,17376372,2290000000000.0,6,5,11,NF
2857,2013,Rwanda,4,477504,7815599503.0,6,5,11,NF
2858,2013,Saudi Arabia,6,706410,747000000000.0,7,7,14,NF
2859,2013,Senegal,3,345215,18918668644.0,2,2,4,F
2860,2013,Somalia,342,40998394,3892402685.0,7,7,14,NF
2861,2013,South Africa,13,1546126,401000000000.0,2,2,4,F
2862,2013,South Sudan,13,1553837,18426469017.0,6,6,12,NF
2863,2013,Spain,5,590660,1350000000000.0,1,1,2,F
2864,2013,Sri Lanka,14,1634777,74317806538.0,5,4,9,PF
2865,2013,Sudan,46,5460515,43024018082.0,7,7,14,NF
2866,2013,Switzerland,2,227887,713000000000.0,1,1,2,F
2867,2013,Syria,285,33877267,20345458471.0,7,7,14,NF
2868,2013,Tanzania,7,825940,45680532614.0,3,3,6,PF
2869,2013,Thailand,472,56016247,420000000000.0,4,4,8,PF
2870,2013,Trinidad and Tobago,3,366459,27268478565.0,2,2,4,F
2871,2013,Tunisia,29,3464749,48683848564.0,3,3,6,PF
2872,2013,Turkey,42,4959532,958000000000.0,3,4,7,PF
2873,2013,Ukraine,5,599982,190000000000.0,4,3,7,PF
2874,2013,United Arab Emirates,1,121023,390000000000.0,6,6,12,NF
2875,2013,United Kingdom,137,16289217,2800000000000.0,1,1,2,F
2876,2013,United States,20,2355875,16800000000000.0,1,1,2,F
2877,2013,Zimbabwe,3,355065,19091020000.0,5,6,11,NF
2878,2014,Afghanistan,1824,245105442,20497126770.0,6,6,12,NF
2879,2014,Albania,2,266179,13228147516.0,3,3,6,PF
2880,2014,Algeria,13,1757724,214000000000.0,6,5,11,NF
2881,2014,Argentina,1,139097,526000000000.0,2,2,4,F
2882,2014,Australia,8,1089604,1470000000000.0,1,1,2,F
2883,2014,Azerbaijan,3,410622,75244294275.0,6,6,12,NF
2884,2014,Bahrain,42,5615120,33387712766.0,7,6,13,NF
2885,2014,Bangladesh,130,16950022,173000000000.0,4,4,8,PF
2886,2014,Belgium,2,270270,535000000000.0,1,1,2,F
2887,2014,Bhutan,1,136273,1907090813.0,3,4,7,PF
2888,2014,Bosnia-Herzegovina,3,417441,18560861389.0,4,3,7,PF
2889,2014,Brazil,3,391585,2460000000000.0,2,2,4,F
2890,2014,Bulgaria,1,129678,57082011260.0,2,2,4,F
2891,2014,Burundi,5,660515,2705783272.0,6,5,11,NF
2892,2014,Cameroon,68,9362538,36386546918.0,6,6,12,NF
2893,2014,Canada,3,411898,1810000000000.0,1,1,2,F
2894,2014,Central African Republic,94,12466584,1894813505.0,7,7,14,NF
2895,2014,Chad,1,136086,13940768066.0,7,6,13,NF
2896,2014,Chile,17,2312676,261000000000.0,1,1,2,F
2897,2014,China,37,4908212,10500000000000.0,7,6,13,NF
2898,2014,Colombia,231,31049897,381000000000.0,3,4,7,PF
2899,2014,Cyprus,5,667604,23156850007.0,1,1,2,F
2900,2014,Czech Republic,5,677818,209000000000.0,1,1,2,F
2901,2014,Djibouti,1,132377,2214679081.0,6,5,11,NF
2902,2014,Dominican Republic,1,139724,67179914027.0,2,3,5,F
2903,2014,Egypt,354,47544619,306000000000.0,6,5,11,NF
2904,2014,Ethiopia,2,263715,55612228234.0,6,6,12,NF
2905,2014,France,14,1877194,2850000000000.0,1,1,2,F
2906,2014,Georgia,2,256997,17627003455.0,3,3,6,PF
2907,2014,Germany,13,1775069,3880000000000.0,1,1,2,F
2908,2014,Ghana,1,136979,54782847753.0,1,2,3,F
2909,2014,Greece,26,3518658,235000000000.0,2,2,4,F
2910,2014,Honduras,1,131820,19618567250.0,4,4,8,PF
2911,2014,Hungary,1,125862,141000000000.0,2,2,4,F
2912,2014,Iceland,1,130514,17867662178.0,1,1,2,F
2913,2014,India,860,114998098,2040000000000.0,2,3,5,F
2914,2014,Indonesia,35,4676863,891000000000.0,2,4,6,PF
2915,2014,Iran,9,1231175,433000000000.0,6,6,12,NF
2916,2014,Iraq,3934,523075916,228000000000.0,6,6,12,NF
2917,2014,Ireland,33,4458276,259000000000.0,1,1,2,F
2918,2014,Israel,293,39597250,311000000000.0,1,2,3,F
2919,2014,Italy,7,935574,2160000000000.0,1,1,2,F
2920,2014,Jamaica,1,130456,13899228824.0,2,3,5,F
2921,2014,Japan,5,642491,4900000000000.0,1,1,2,F
2922,2014,Jordan,3,399464,36847643521.0,6,5,11,NF
2923,2014,Kenya,115,15412176,68285768554.0,4,4,8,PF
2924,2014,Kosovo,4,531247,7074657898.0,4,4,8,PF
2925,2014,Kyrgyzstan,2,267972,7468096567.0,5,5,10,PF
2926,2014,Lebanon,205,27316704,48133414840.0,5,4,9,PF
2927,2014,Liberia,1,136662,3225652000.0,3,4,7,PF
2928,2014,Libya,729,97929109,41142722414.0,6,6,12,NF
2929,2014,Madagascar,1,126417,12522957228.0,4,4,8,PF
2930,2014,Malaysia,12,1587245,338000000000.0,4,4,8,PF
2931,2014,Maldives,9,1204649,3697351597.0,4,4,8,PF
2932,2014,Mali,69,9367161,14364937997.0,5,4,9,PF
2933,2014,Malta,1,140071,11626281387.0,1,1,2,F
2934,2014,Mexico,5,653584,1320000000000.0,3,3,6,PF
2935,2014,Mozambique,22,2898266,17716084108.0,4,3,7,PF
2936,2014,Myanmar,16,2167162,63264891867.0,6,6,12,NF
2937,2014,Nepal,7,946215,22731602970.0,3,4,7,PF
2938,2014,Netherlands,1,135860,891000000000.0,1,1,2,F
2939,2014,New Zealand,1,127047,201000000000.0,1,1,2,F
2940,2014,Nicaragua,2,270645,11880434071.0,4,3,7,PF
2941,2014,Niger,5,691589,10862944204.0,3,4,7,PF
2942,2014,Nigeria,714,95846457,547000000000.0,4,5,9,PF
2943,2014,Pakistan,2151,286890210,244000000000.0,4,5,9,PF
2944,2014,Paraguay,15,2039539,40377987209.0,3,3,6,PF
2945,2014,Peru,12,1593525,201000000000.0,2,3,5,F
2946,2014,Philippines,597,80300682,297000000000.0,3,3,6,PF
2947,2014,Russia,48,6389171,2060000000000.0,6,6,12,NF
2948,2014,Rwanda,2,257413,8241332517.0,6,6,12,NF
2949,2014,Saudi Arabia,14,1894973,756000000000.0,7,7,14,NF
2950,2014,Senegal,2,272061,19797254643.0,2,2,4,F
2951,2014,Somalia,872,116469609,3963532302.0,7,7,14,NF
2952,2014,South Africa,20,2708055,381000000000.0,2,2,4,F
2953,2014,South Sudan,40,5275131,13962212847.0,7,6,13,NF
2954,2014,Spain,4,555596,1370000000000.0,1,1,2,F
2955,2014,Sri Lanka,16,2147537,79356449841.0,5,5,10,PF
2956,2014,Sudan,157,20919862,49516748618.0,7,7,14,NF
2957,2014,Sweden,5,693772,582000000000.0,1,1,2,F
2958,2014,Syria,331,44398672,21239000398.0,7,7,14,NF
2959,2014,Tajikistan,1,132412,9112544556.0,6,6,12,NF
2960,2014,Tanzania,11,1442602,49964788814.0,3,3,6,PF
2961,2014,Thailand,423,55726149,407000000000.0,6,5,11,NF
2962,2014,Tunisia,23,3122058,50271342086.0,1,3,4,F
2963,2014,Turkey,95,12815458,939000000000.0,3,4,7,PF
2964,2014,Turkmenistan,1,127979,43524210526.0,7,7,14,NF
2965,2014,Uganda,6,813569,32612397758.0,6,5,11,NF
2966,2014,Ukraine,895,121911456,134000000000.0,3,3,6,PF
2967,2014,United Arab Emirates,2,282327,403000000000.0,6,6,12,NF
2968,2014,United Kingdom,103,13808855,3090000000000.0,1,1,2,F
2969,2014,United States,29,3941366,17500000000000.0,1,1,2,F
2970,2014,Zimbabwe,1,127915,19495519600.0,5,6,11,NF
2971,2015,Afghanistan,1928,289192429,19134211764.0,6,6,12,NF
2972,2015,Albania,4,577190,11386850130.0,3,3,6,PF
2973,2015,Algeria,15,2248440,166000000000.0,6,5,11,NF
2974,2015,Argentina,1,155896,595000000000.0,2,2,4,F
2975,2015,Armenia,2,300473,10553337673.0,5,4,9,PF
2976,2015,Australia,14,2107043,1350000000000.0,1,1,2,F
2977,2015,Bahrain,18,2694577,31050638298.0,7,6,13,NF
2978,2015,Bangladesh,469,68267490,195000000000.0,4,4,8,PF
2979,2015,Bosnia-Herzegovina,6,910564,16219819017.0,4,3,7,PF
2980,2015,Brazil,5,753300,1800000000000.0,2,2,4,F
2981,2015,Bulgaria,2,292170,50781996713.0,2,2,4,F
2982,2015,Burkina Faso,6,914377,11832159276.0,4,3,7,PF
2983,2015,Burundi,102,15578145,3104394858.0,7,6,13,NF
2984,2015,Cameroon,83,12512272,32210232912.0,6,6,12,NF
2985,2015,Canada,5,761253,1560000000000.0,1,1,2,F
2986,2015,Central African Republic,48,7299514,1695825708.0,7,7,14,NF
2987,2015,Chad,27,4100644,10950392220.0,7,6,13,NF
2988,2015,Chile,1,144801,244000000000.0,1,1,2,F
2989,2015,China,17,2530907,11100000000000.0,7,6,13,NF
2990,2015,Colombia,136,20372775,293000000000.0,3,4,7,PF
2991,2015,Cyprus,3,434712,19842404305.0,1,1,2,F
2992,2015,Czech Republic,4,598920,188000000000.0,1,1,2,F
2993,2015,Denmark,5,742549,303000000000.0,1,1,2,F
2994,2015,Djibouti,1,156864,2430274292.0,6,5,11,NF
2995,2015,Ecuador,1,150620,99290381000.0,3,3,6,PF
2996,2015,Egypt,647,95728262,329000000000.0,6,5,11,NF
2997,2015,Estonia,2,309457,22881558192.0,1,1,2,F
2998,2015,Ethiopia,7,1085074,64589334979.0,7,6,13,NF
2999,2015,Finland,9,1402411,234000000000.0,1,1,2,F
3000,2015,France,37,5508802,2440000000000.0,1,1,2,F
3001,2015,Georgia,1,147077,14953950557.0,3,3,6,PF
3002,2015,Germany,66,10095645,3360000000000.0,1,1,2,F
3003,2015,Greece,31,4685364,196000000000.0,2,2,4,F
3004,2015,Guinea,2,289691,8794202444.0,5,5,10,PF
3005,2015,Hungary,1,148227,125000000000.0,2,2,4,F
3006,2015,India,885,132882411,2100000000000.0,2,3,5,F
3007,2015,Indonesia,29,4382971,861000000000.0,2,4,6,PF
3008,2015,Iran,9,1365769,385000000000.0,6,6,12,NF
3009,2015,Iraq,2751,413021990,167000000000.0,5,6,11,NF
3010,2015,Ireland,28,4213810,291000000000.0,1,1,2,F
3011,2015,Israel,58,8869641,300000000000.0,1,2,3,F
3012,2015,Italy,5,774622,1840000000000.0,1,1,2,F
3013,2015,Japan,10,1515658,4440000000000.0,1,1,2,F
3014,2015,Jordan,4,611971,38587017887.0,6,5,11,NF
3015,2015,Kenya,70,10528816,70120413329.0,4,4,8,PF
3016,2015,Kosovo,2,303104,6295820482.0,3,4,7,PF
3017,2015,Kuwait,1,149844,115000000000.0,5,5,10,PF
3018,2015,Kyrgyzstan,3,458125,6678178340.0,5,5,10,PF
3019,2015,Lebanon,44,6535210,50065946086.0,5,4,9,PF
3020,2015,Lesotho,1,143856,2359759799.0,3,3,6,PF
3021,2015,Libya,543,81283281,27842131480.0,6,6,12,NF
3022,2015,Malaysia,5,726092,301000000000.0,4,4,8,PF
3023,2015,Maldives,2,308658,4109424800.0,4,5,9,PF
3024,2015,Mali,121,18038252,13104764334.0,5,4,9,PF
3025,2015,Malta,1,150324,11091434484.0,1,1,2,F
3026,2015,Mexico,19,2881170,1170000000000.0,3,3,6,PF
3027,2015,Montenegro,1,148049,4052913386.0,3,3,6,PF
3028,2015,Morocco,1,155153,101000000000.0,5,4,9,PF
3029,2015,Mozambique,8,1216387,15950969019.0,4,4,8,PF
3030,2015,Myanmar,37,5479175,63045306514.0,6,5,11,NF
3031,2015,Nepal,48,7382280,24360795410.0,3,4,7,PF
3032,2015,Netherlands,3,452850,765000000000.0,1,1,2,F
3033,2015,Niger,41,6086299,9683867894.0,3,4,7,PF
3034,2015,Nigeria,639,94987134,487000000000.0,4,5,9,PF
3035,2015,Pakistan,1243,185605099,271000000000.0,4,5,9,PF
3036,2015,Paraguay,19,2844704,36211372703.0,3,3,6,PF
3037,2015,Peru,10,1494902,190000000000.0,2,3,5,F
3038,2015,Philippines,721,108297350,306000000000.0,3,3,6,PF
3039,2015,Qatar,1,146624,162000000000.0,6,5,11,NF
3040,2015,Russia,21,3199028,1360000000000.0,6,6,12,NF
3041,2015,Saudi Arabia,103,15574031,654000000000.0,7,7,14,NF
3042,2015,Senegal,2,305333,17774766636.0,2,2,4,F
3043,2015,Somalia,422,63455983,4048860871.0,7,7,14,NF
3044,2015,South Africa,5,763009,347000000000.0,2,2,4,F
3045,2015,South Korea,1,145289,1470000000000.0,2,2,4,F
3046,2015,South Sudan,54,8061686,11997800760.0,7,6,13,NF
3047,2015,Spain,1,157055,1200000000000.0,1,1,2,F
3048,2015,Sri Lanka,11,1634401,80604080689.0,4,4,8,PF
3049,2015,Sudan,158,23659012,51726758677.0,7,7,14,NF
3050,2015,Sweden,32,4920652,505000000000.0,1,1,2,F
3051,2015,Syria,491,73524772,16492072144.0,7,7,14,NF
3052,2015,Tajikistan,3,460696,8271454301.0,7,6,13,NF
3053,2015,Tanzania,14,2110103,47378599025.0,3,4,7,PF
3054,2015,Thailand,278,41889374,401000000000.0,6,5,11,NF
3055,2015,Trinidad and Tobago,1,149773,24959858249.0,2,2,4,F
3056,2015,Tunisia,19,2852459,45780069047.0,1,3,4,F
3057,2015,Turkey,424,64597406,864000000000.0,3,4,7,PF
3058,2015,Uganda,10,1503977,32387183845.0,6,5,11,NF
3059,2015,Ukraine,638,94002735,91030959455.0,3,3,6,PF
3060,2015,United Kingdom,115,17271500,2960000000000.0,1,1,2,F
3061,2015,United States,38,5752950,18200000000000.0,1,1,2,F
3062,2015,Uzbekistan,1,153631,86196265192.0,7,7,14,NF
3063,2016,Afghanistan,1617,265227211,18116562465.0,6,6,12,NF
3064,2016,Albania,2,329056,11861199831.0,3,3,6,PF
3065,2016,Algeria,9,1478682,160000000000.0,6,5,11,NF
3066,2016,Angola,2,328592,101000000000.0,6,6,12,NF
3067,2016,Argentina,2,325941,558000000000.0,2,2,4,F
3068,2016,Armenia,2,328189,10546135160.0,5,4,9,PF
3069,2016,Australia,9,1490226,1210000000000.0,1,1,2,F
3070,2016,Austria,3,499121,396000000000.0,1,1,2,F
3071,2016,Azerbaijan,2,331955,37867518957.0,7,6,13,NF
3072,2016,Bahrain,3,498560,32234973404.0,7,6,13,NF
3073,2016,Bangladesh,89,14630076,221000000000.0,4,4,8,PF
3074,2016,Belgium,6,991401,476000000000.0,1,1,2,F
3075,2016,Brazil,2,330437,1800000000000.0,2,2,4,F
3076,2016,Bulgaria,1,168660,53953897624.0,2,2,4,F
3077,2016,Burkina Faso,10,1619789,12833363370.0,4,3,7,PF
3078,2016,Burundi,83,13365378,2732808557.0,7,6,13,NF
3079,2016,Cameroon,56,9151207,33814337900.0,6,6,12,NF
3080,2016,Canada,6,975400,1530000000000.0,1,1,2,F
3081,2016,Central African Republic,38,6247636,1825018191.0,7,7,14,NF
3082,2016,Chad,5,820599,10097778354.0,7,6,13,NF
3083,2016,Chile,18,2919093,250000000000.0,1,1,2,F
3084,2016,China,5,841431,11200000000000.0,7,6,13,NF
3085,2016,Colombia,110,18078872,283000000000.0,3,3,6,PF
3086,2016,Cyprus,2,329568,20953442550.0,1,1,2,F
3087,2016,Czech Republic,2,325092,196000000000.0,1,1,2,F
3088,2016,Denmark,1,166643,313000000000.0,1,1,2,F
3089,2016,Ecuador,6,1000306,99937696000.0,3,4,7,PF
3090,2016,Egypt,376,61898747,332000000000.0,6,5,11,NF
3091,2016,Ethiopia,13,2102400,74296618481.0,7,6,13,NF
3092,2016,Finland,3,482685,241000000000.0,1,1,2,F
3093,2016,France,26,4261017,2470000000000.0,1,2,3,F
3094,2016,Georgia,4,663224,15141758567.0,3,3,6,PF
3095,2016,Germany,44,7226257,3470000000000.0,1,1,2,F
3096,2016,Ghana,1,168828,56165172899.0,1,2,3,F
3097,2016,Greece,30,4918606,193000000000.0,2,2,4,F
3098,2016,Guinea,1,158614,8595955581.0,5,5,10,PF
3099,2016,Guyana,1,163303,4482697337.0,2,3,5,F
3100,2016,Haiti,1,162522,13987693739.0,5,5,10,PF
3101,2016,Honduras,1,168294,21566622850.0,4,4,8,PF
3102,2016,Hungary,1,167446,129000000000.0,3,2,5,F
3103,2016,India,1026,168464114,2290000000000.0,2,3,5,F
3104,2016,Indonesia,19,3129232,932000000000.0,2,4,6,PF
3105,2016,Iran,10,1658138,418000000000.0,6,6,12,NF
3106,2016,Iraq,3383,554906250,167000000000.0,5,6,11,NF
3107,2016,Ireland,15,2455125,299000000000.0,1,1,2,F
3108,2016,Israel,50,8158729,319000000000.0,1,2,3,F
3109,2016,Italy,11,1799386,1880000000000.0,1,1,2,F
3110,2016,Japan,1,165258,5000000000000.0,1,1,2,F
3111,2016,Jordan,11,1837356,39892551127.0,5,5,10,PF
3112,2016,Kazakhstan,3,490092,137000000000.0,7,5,12,NF
3113,2016,Kenya,65,10765366,74815121315.0,4,4,8,PF
3114,2016,Kosovo,8,1325778,6682832632.0,3,4,7,PF
3115,2016,Kuwait,2,327337,109000000000.0,5,5,10,PF
3116,2016,Kyrgyzstan,4,658366,6813092066.0,5,5,10,PF
3117,2016,Lebanon,41,6748415,51389318291.0,5,4,9,PF
3118,2016,Libya,422,68662030,26197143268.0,7,6,13,NF
3119,2016,Madagascar,1,164158,11848613735.0,3,4,7,PF
3120,2016,Malaysia,19,3141271,301000000000.0,4,4,8,PF
3121,2016,Maldives,1,157644,4379136462.0,5,5,10,PF
3122,2016,Mali,100,16444513,14026048691.0,5,4,9,PF
3123,2016,Mexico,5,824916,1080000000000.0,3,3,6,PF
3124,2016,Moldova,1,158415,8071480541.0,3,3,6,PF
3125,2016,Mozambique,79,13013918,11936999283.0,4,4,8,PF
3126,2016,Myanmar,74,12418175,60291738935.0,5,5,10,PF
3127,2016,Nepal,43,7071031,24524098184.0,3,4,7,PF
3128,2016,Netherlands,6,988811,784000000000.0,1,1,2,F
3129,2016,New Zealand,1,158574,189000000000.0,1,1,2,F
3130,2016,Niger,25,4121652,10398862245.0,4,4,8,PF
3131,2016,Nigeria,534,87720622,405000000000.0,3,5,8,PF
3132,2016,Pakistan,864,141732670,279000000000.0,4,5,9,PF
3133,2016,Panama,1,160701,57907695409.0,2,2,4,F
3134,2016,Paraguay,15,2491001,36089550659.0,3,3,6,PF
3135,2016,Peru,4,651429,192000000000.0,2,3,5,F
3136,2016,Philippines,632,103074406,319000000000.0,3,3,6,PF
3137,2016,Poland,2,325466,473000000000.0,1,2,3,F
3138,2016,Russia,55,9055195,1280000000000.0,7,6,13,NF
3139,2016,Rwanda,1,161240,8690485823.0,6,6,12,NF
3140,2016,Saudi Arabia,124,20474873,645000000000.0,7,7,14,NF
3141,2016,Sierra Leone,1,170616,3674794530.0,3,3,6,PF
3142,2016,Somalia,602,99112737,4198485404.0,7,7,14,NF
3143,2016,South Africa,27,4450989,324000000000.0,2,2,4,F
3144,2016,South Korea,1,170034,1500000000000.0,2,2,4,F
3146,2016,Spain,3,495630,1230000000000.0,1,1,2,F
3147,2016,Sri Lanka,1,157334,82401038710.0,3,4,7,PF
3148,2016,Sudan,173,28339715,42630376000.0,7,7,14,NF
3149,2016,Sweden,16,2609271,516000000000.0,1,1,2,F
3150,2016,Switzerland,2,337422,696000000000.0,1,1,2,F
3151,2016,Syria,473,77896980,12356980639.0,7,7,14,NF
3152,2016,Tajikistan,2,326544,6992393787.0,7,6,13,NF
3153,2016,Tanzania,3,483028,49774021003.0,3,4,7,PF
3154,2016,Thailand,329,54050007,413000000000.0,6,5,11,NF
3155,2016,Tunisia,12,1950849,44360775649.0,1,3,4,F
3156,2016,Turkey,544,89024480,870000000000.0,4,5,9,PF
3157,2016,Uganda,15,2484086,29203988815.0,6,5,11,NF
3158,2016,Ukraine,61,9935827,93355993629.0,3,3,6,PF
3159,2016,United Kingdom,104,17016611,2720000000000.0,1,1,2,F
3160,2016,United States,67,11080104,18700000000000.0,1,1,2,F
3161,2016,Uruguay,1,159847,57236652490.0,1,1,2,F
3162,2017,Afghanistan,1414,249778048,18753469630.0,5,6,11,NF
3163,2017,Albania,1,179753,13019689337.0,3,3,6,PF
3164,2017,Algeria,14,2453478,170000000000.0,6,5,11,NF
3165,2017,Angola,6,1045388,122000000000.0,6,6,12,NF
3166,2017,Argentina,3,531966,644000000000.0,2,2,4,F
3167,2017,Australia,4,708330,1330000000000.0,1,1,2,F
3168,2017,Austria,1,176659,416000000000.0,1,1,2,F
3169,2017,Azerbaijan,2,345501,40865558912.0,7,6,13,NF
3170,2017,Bahrain,21,3672896,35473776596.0,7,6,13,NF
3171,2017,Bangladesh,41,7191797,250000000000.0,4,4,8,PF
3172,2017,Belgium,3,529213,502000000000.0,1,1,2,F
3173,2017,Brazil,2,353451,2060000000000.0,2,2,4,F
3174,2017,Burkina Faso,32,5664097,14106956830.0,4,3,7,PF
3175,2017,Burundi,21,3690541,2748180474.0,7,6,13,NF
3176,2017,Cameroon,110,19566597,36098550142.0,6,6,12,NF
3177,2017,Canada,12,2114579,1650000000000.0,1,1,2,F
3178,2017,Central African Republic,43,7536780,2072349794.0,7,7,14,NF
3179,2017,Chad,6,1061974,10000395242.0,7,6,13,NF
3180,2017,Chile,12,2115253,277000000000.0,1,1,2,F
3181,2017,China,6,1050070,12300000000000.0,7,6,13,NF
3182,2017,Colombia,119,20932391,312000000000.0,3,3,6,PF
3183,2017,Czech Republic,3,530930,219000000000.0,1,1,2,F
3184,2017,Djibouti,1,176556,2751445574.0,6,5,11,NF
3185,2017,Dominican Republic,1,172187,79997975622.0,3,3,6,PF
3186,2017,Ecuador,3,515942,104000000000.0,3,3,6,PF
3187,2017,Egypt,225,39531328,236000000000.0,6,6,12,NF
3188,2017,Ethiopia,27,4706565,81770791971.0,7,6,13,NF
3189,2017,Finland,2,351589,255000000000.0,1,1,2,F
3190,2017,France,41,7235158,2590000000000.0,1,2,3,F
3191,2017,Gabon,4,709798,14929488771.0,7,5,12,NF
3192,2017,Georgia,1,179989,16242916916.0,3,3,6,PF
3193,2017,Germany,27,4754638,3680000000000.0,1,1,2,F
3194,2017,Greece,44,7752248,199000000000.0,2,2,4,F
3195,2017,Honduras,1,174801,22975415842.0,4,4,8,PF
3196,2017,India,967,170517831,2650000000000.0,2,3,5,F
3197,2017,Indonesia,27,4810069,1020000000000.0,2,4,6,PF
3198,2017,Iran,11,1930573,445000000000.0,6,6,12,NF
3199,2017,Iraq,2503,440607026,187000000000.0,5,6,11,NF
3200,2017,Ireland,17,2997201,335000000000.0,1,1,2,F
3201,2017,Israel,34,6013161,355000000000.0,1,3,4,F
3202,2017,Italy,8,1415675,1960000000000.0,1,1,2,F
3203,2017,Jamaica,2,359040,14808989993.0,2,3,5,F
3204,2017,Jordan,8,1416361,41408960845.0,5,5,10,PF
3205,2017,Kenya,97,17199187,82035800868.0,4,4,8,PF
3206,2017,Kosovo,8,1410447,7180813376.0,3,4,7,PF
3207,2017,Kyrgyzstan,3,526129,7702934800.0,5,5,10,PF
3208,2017,Latvia,1,181498,30408509602.0,2,2,4,F
3209,2017,Lebanon,23,4053489,53324800959.0,6,4,10,PF
3210,2017,Liberia,1,179962,3390703400.0,3,3,6,PF
3211,2017,Libya,191,33636803,37883243650.0,7,6,13,NF
3212,2017,Malawi,1,180988,8943543677.0,3,3,6,PF
3213,2017,Malaysia,4,704773,319000000000.0,4,4,8,PF
3214,2017,Maldives,2,351969,4754175869.0,5,5,10,PF
3215,2017,Mali,142,25059215,15365714371.0,5,4,9,PF
3216,2017,Malta,3,534300,13221298308.0,1,1,2,F
3217,2017,Mexico,20,3504200,1160000000000.0,3,3,6,PF
3218,2017,Mozambique,15,2686490,13219084261.0,4,4,8,PF
3219,2017,Myanmar,116,20581947,61449391917.0,5,5,10,PF
3220,2017,Nepal,247,44089761,28971589213.0,3,4,7,PF
3221,2017,Netherlands,1,181286,832000000000.0,1,1,2,F
3222,2017,Niger,13,2288566,11185102400.0,4,4,8,PF
3223,2017,Nigeria,485,85706811,376000000000.0,3,5,8,PF
3224,2017,Norway,1,173881,398000000000.0,1,1,2,F
3225,2017,Pakistan,719,126727318,305000000000.0,4,5,9,PF
3226,2017,Papua New Guinea,8,1417922,22742613554.0,3,3,6,PF
3227,2017,Paraguay,10,1764742,38997129474.0,3,3,6,PF
3228,2017,Peru,8,1392631,211000000000.0,2,3,5,F
3229,2017,Philippines,692,122108874,328000000000.0,3,3,6,PF
3230,2017,Poland,1,172226,527000000000.0,1,2,3,F
3231,2017,Russia,33,5832727,1570000000000.0,7,6,13,NF
3232,2017,Rwanda,2,350988,9253098954.0,6,6,12,NF
3233,2017,Saudi Arabia,54,9481281,689000000000.0,7,7,14,NF
3234,2017,Serbia,1,171027,44179055280.0,3,2,5,F
3235,2017,Sierra Leone,3,530063,3719369107.0,3,3,6,PF
3236,2017,Somalia,615,108319893,4508845348.0,7,7,14,NF
3237,2017,South Africa,29,5096842,381000000000.0,2,2,4,F
3239,2017,Spain,4,711987,1310000000000.0,1,1,2,F
3240,2017,Sri Lanka,41,7196299,87428128124.0,3,4,7,PF
3241,2017,Sudan,106,18652696,41283617976.0,7,7,14,NF
3242,2017,Sweden,18,3169304,541000000000.0,1,1,2,F
3243,2017,Syria,248,43611339,16112991412.0,7,7,14,NF
3244,2017,Tajikistan,2,344760,7536439875.0,7,6,13,NF
3245,2017,Tanzania,6,1064167,53320625959.0,4,4,8,PF
3246,2017,Thailand,179,31430518,456000000000.0,6,5,11,NF
3247,2017,Tunisia,4,701950,42163974956.0,2,3,5,F
3248,2017,Turkey,181,32002436,859000000000.0,5,6,11,NF
3249,2017,Uganda,13,2314190,30744473912.0,6,4,10,PF
3250,2017,Ukraine,62,10935254,112000000000.0,3,3,6,PF
3251,2017,United Kingdom,123,21723315,2700000000000.0,1,1,2,F
3252,2017,United States,66,11603888,19500000000000.0,2,1,3,F
3253,2017,Vietnam,2,348192,224000000000.0,7,5,12,NF
3254,2017,Zambia,2,353725,25873601261.0,4,4,8,PF
3255,2017,Zimbabwe,3,531501,17584890937.0,6,5,11,NF
3256,2018,Afghanistan,1776,332366984,18053228579.0,5,6,11,NF
3257,2018,Algeria,7,1296469,175000000000.0,6,5,11,NF
3258,2018,Argentina,5,943016,525000000000.0,2,2,4,F
3259,2018,Armenia,1,189966,12457941907.0,4,4,8,PF
3260,2018,Australia,3,559072,1430000000000.0,1,1,2,F
3261,2018,Austria,1,183725,455000000000.0,1,1,2,F
3262,2018,Azerbaijan,1,186861,47112941176.0,7,6,13,NF
3263,2018,Bahrain,1,183962,37801462766.0,7,6,13,NF
3264,2018,Bangladesh,33,6162866,274000000000.0,5,5,10,PF
3265,2018,Belgium,3,563312,543000000000.0,1,1,2,F
3266,2018,Bolivia,2,366057,40287647930.0,3,3,6,PF
3267,2018,Bosnia-Herzegovina,2,377239,20177409351.0,4,4,8,PF
3268,2018,Brazil,11,2034398,1920000000000.0,2,2,4,F
3269,2018,Bulgaria,1,185358,66363422450.0,2,2,4,F
3270,2018,Burkina Faso,70,13174997,15890065020.0,4,3,7,PF
3271,2018,Burundi,10,1864067,2668495743.0,7,6,13,NF
3272,2018,Cambodia,1,187082,24571753583.0,6,5,11,NF
3273,2018,Cameroon,235,43944587,39973839065.0,6,6,12,NF
3274,2018,Canada,6,1123487,1720000000000.0,1,1,2,F
3275,2018,Central African Republic,46,8564227,2220978978.0,7,7,14,NF
3276,2018,Chad,12,2254853,11239167048.0,7,6,13,NF
3277,2018,Chile,45,8337859,298000000000.0,1,1,2,F
3278,2018,China,1,186751,13900000000000.0,7,6,13,NF
3279,2018,Colombia,205,38140205,334000000000.0,3,3,6,PF
3280,2018,Comoros,2,375023,1188797575.0,4,4,8,PF
3281,2018,Denmark,1,183907,357000000000.0,1,1,2,F
3282,2018,Ecuador,10,1837582,108000000000.0,3,3,6,PF
3283,2018,Egypt,54,10072610,250000000000.0,6,6,12,NF
3284,2018,Ethiopia,10,1883364,84269348327.0,6,6,12,NF
3285,2018,Finland,1,189017,276000000000.0,1,1,2,F
3286,2018,France,13,2414055,2790000000000.0,1,2,3,F
3287,2018,Georgia,1,183310,17599700091.0,3,3,6,PF
3288,2018,Germany,22,4099186,3980000000000.0,1,1,2,F
3289,2018,Ghana,2,364226,67299280680.0,1,2,3,F
3290,2018,Greece,27,5038267,212000000000.0,1,2,3,F
3291,2018,Guatemala,2,376497,73208583759.0,4,4,8,PF
3292,2018,Guinea,2,372160,11857030337.0,5,4,9,PF
3293,2018,Haiti,5,945416,16455034353.0,5,5,10,PF
3294,2018,India,888,165911776,2700000000000.0,2,3,5,F
3295,2018,Indonesia,43,8017488,1040000000000.0,2,4,6,PF
3296,2018,Iran,13,2432952,294000000000.0,6,6,12,NF
3297,2018,Iraq,1362,253441653,227000000000.0,5,6,11,NF
3298,2018,Ireland,5,937552,385000000000.0,1,1,2,F
3299,2018,Israel,63,11796853,374000000000.0,2,3,5,F
3300,2018,Italy,14,2601068,2090000000000.0,1,1,2,F
3301,2018,Japan,1,183335,5040000000000.0,1,1,2,F
3302,2018,Jordan,2,377810,42932112676.0,5,5,10,PF
3303,2018,Kenya,52,9678647,92202956321.0,4,4,8,PF
3304,2018,Kosovo,2,372267,7878508503.0,3,4,7,PF
3305,2018,Kyrgyzstan,1,181939,8271108638.0,5,4,9,PF
3306,2018,Lebanon,7,1299885,55276157552.0,5,4,9,PF
3307,2018,Libya,166,30980024,52607888718.0,7,6,13,NF
3308,2018,Lithuania,1,187975,53724663843.0,1,1,2,F
3309,2018,Malawi,2,376859,9880675786.0,3,3,6,PF
3310,2018,Malaysia,7,1313437,359000000000.0,4,4,8,PF
3311,2018,Maldives,2,371716,5300962660.0,5,5,10,PF
3312,2018,Mali,164,30593907,17070866299.0,4,4,8,PF
3313,2018,Mauritania,1,187973,7354430040.0,6,5,11,NF
3314,2018,Mexico,27,5066011,1220000000000.0,3,3,6,PF
3315,2018,Montenegro,3,552787,5504166667.0,4,3,7,PF
3316,2018,Morocco,1,191150,118000000000.0,5,5,10,PF
3317,2018,Mozambique,63,11829816,14845870051.0,4,4,8,PF
3318,2018,Myanmar,39,7325166,67144726168.0,5,5,10,PF
3319,2018,Nepal,99,18322472,33111525183.0,3,4,7,PF
3320,2018,Netherlands,6,1119587,914000000000.0,1,1,2,F
3321,2018,Nicaragua,7,1306279,13025239912.0,6,5,11,NF
3322,2018,Niger,19,3554819,12808660528.0,4,4,8,PF
3323,2018,Nigeria,645,120168235,397000000000.0,3,5,8,PF
3324,2018,Pakistan,480,89517395,315000000000.0,5,5,10,PF
3325,2018,Paraguay,4,763445,40225448341.0,3,3,6,PF
3326,2018,Peru,5,936142,223000000000.0,2,3,5,F
3327,2018,Philippines,601,112171194,347000000000.0,3,3,6,PF
3328,2018,Poland,1,187713,587000000000.0,2,2,4,F
3329,2018,Russia,23,4294141,1660000000000.0,7,6,13,NF
3330,2018,Rwanda,5,941701,9640280084.0,6,6,12,NF
3331,2018,Saudi Arabia,92,17149195,787000000000.0,7,7,14,NF
3332,2018,Senegal,3,554959,23116699808.0,2,3,5,F
3333,2018,Serbia,2,380642,50640650221.0,3,3,6,PF
3334,2018,Somalia,527,98278512,4720727283.0,7,7,14,NF
3335,2018,South Africa,41,7670608,405000000000.0,2,2,4,F
3336,2018,South Korea,1,183026,1720000000000.0,2,2,4,F
3338,2018,Spain,2,372415,1420000000000.0,1,1,2,F
3339,2018,Sri Lanka,7,1299300,87963042341.0,3,4,7,PF
3340,2018,Sudan,42,7807278,30964349685.0,7,7,14,NF
3341,2018,Sweden,5,929374,555000000000.0,1,1,2,F
3342,2018,Switzerland,1,182704,736000000000.0,1,1,2,F
3343,2018,Syria,232,43330953,21490335086.0,7,7,14,NF
3344,2018,Tajikistan,3,566159,7765014424.0,7,6,13,NF
3345,2018,Tanzania,3,558762,57003713611.0,4,5,9,PF
3346,2018,Thailand,182,34041472,507000000000.0,7,5,12,NF
3347,2018,Trinidad and Tobago,1,188875,23679919655.0,2,2,4,F
3348,2018,Tunisia,19,3548914,42570270107.0,2,3,5,F
3349,2018,Turkey,94,17399672,778000000000.0,5,6,11,NF
3350,2018,Uganda,10,1869263,32927025573.0,6,5,11,NF
3351,2018,Ukraine,34,6324587,131000000000.0,3,4,7,PF
3352,2018,United Kingdom,100,18717273,2900000000000.0,1,1,2,F
3353,2018,United States,67,12592012,20600000000000.0,2,1,3,F
3354,2018,Vietnam,1,186538,245000000000.0,7,5,12,NF
3355,2018,Zimbabwe,2,374446,18115543791.0,5,5,10,PF
